新当选的赞比亚总统在竞选时曾提出一些威胁中国的言论，中国就此威胁要退出赞比亚，不知道这样的现象是否说明中国对一些非洲国家内政的干涉？	提出	退出	1
2006年赞比亚大选时，当时的总统候选人，也就是今年选举当选的总统在竞选时声称一旦当选就要同台湾建立所谓“外交关系”。	选举	建立	1
美国国务院在当天的声明中表示，伯恩斯将于10月24日在得克萨斯州A＆M大学就美中关系发表演讲，然后他将于本月26日至29日先后访问日本和中国。	发表	访问	1
兵役法修正案草案退役军人报考公务员优先录用中新社北京10月24日电 (记者 周兆军)中国全国人大常委会24日第二次审议兵役法修正案草案。	报考	审议	1
面对境遇困窘的欧洲债务问题，一直对欧元区保持旁观的英国再次出现“退出欧盟”的呼声， 81名保守党议员昨天“逼宫”卡梅伦，呼吁政府就是否退出欧盟进行公投。	出现	逼宫|呼吁|进行	1
此外，应用征收房产税的方式，在扣除一定的住房面积之后，对存量房进行征税，这样就可以加大对持有人的现金流的压力，可以鼓励一些人用投资房来出租。	扣除	征税	1
但是现在确实有一个信息不是特别清楚的问题，我们正在努力建设城镇个人住房信息系统，这个信息系统的建设老实说很艰难，我们准备先在四十个城市进行试点，试点的进程是先把四十个城市自身个人的住房信息收集起来，然后尽快实行全国的联网。	收集	实行	1
托卡耶夫高度评价中国在经济社会发展方面取得的巨大成就，赞赏中方40年来在联合国各领域做出的重要贡献，期待中国在多边舞台发挥更大的作用，联合国日内瓦办事处愿进一步加强与中方的沟通与合作。	取得	发挥|加强	1
住建部：个人住房信息系统建立后将不再限购中广网北京10月28日消息(记者马闯 张华杰) 据中国之声《新闻纵横》报道，昨天上午，在人民大会堂金色大厅，十一届全国人大常委会第二十三次会议召开了联组会议，就国务院关于城镇保障性住房建设和管理工作情况的报告开展专题询问。	召开	开展	1
他此次受泰国主要领导人委托专程前来清莱府，就是为了进一步推动调查工作，尽快查明具体案情并依法处理。	前来	推动|查明|处理	1
答：中方欢迎欧盟峰会就应对欧洲主权债务危机达成共识，这有利于提振市场信心，恢复欧盟和欧元区的经济增长，为欧洲一体化注入新活力。	达成	恢复|注入	1
他此次受泰国主要领导人委托专程前来清莱府，就是为了进一步推动调查工作，尽快查明具体案情并依法进行处理。	前来	推动|查明|进行|处理	1
程国平表示，本次会议上，温总理将同其他各国领导人全面总结上合组织过去一年来各领域合作进展情况，深入分析当前国际和地区形势，并结合落实阿斯塔纳峰会共识，就本组织下一步工作作出部署和规划。	总结	作出	1
根据各方商谈情况，本次会议预计将取得以下成果：一是就世界和上合组织地区经济形势充分交换意见，形成共同的看法和主张，并就此发表《联合声明》；二是深入总结上合组织经济、人文合作经验和成果，规划未来工作的重点方向；三是继续推进多方参与、互利共赢的经贸合作，制定进一步推动项目合作的措施；四是完善组织建设，提高常设机构的工作活力。	交换	形成|发表	1
也正是因此，神八升空之后的控制动作将非常的密集，在今天中午12点左右，神八运动到第五圈届时将进行第一次轨道控制，抬升它的近地点高度。	控制	进行|抬升	1
这样经过5次远距离的导引控制，在3号凌晨时就可以进行第一次交会对接。	控制	进行	1
一是保持密切的高层往来，及时就双边关系及重大国际问题交换看法、协调立场；二是扩大两国贸易规模和相互投资，相互促进，共同增长；三是以明年中德建交40周年纪念活动、“中国文化年”等活动为依托，大力推动人文交流；四是继续加强在联合国、二十国集团内的多边合作，共同应对全球性挑战。	保持	交换	1
欧盟已就克服欧债危机作出重要决定，希望中方一如既往，在帮助欧洲摆脱危机影响、推动世界经济稳定复苏方面发挥建设性作用。	克服|作出	帮助欧洲摆脱|推动|发挥	1
在中国日前先后出台“铁路建设债券利息收入企业所得税减半征收”、“明确铁路建设债券为政府支持债券”等政策作用下，市场对铁道部债券信心和认可度大幅上升，10月26日铁道部第二期200亿铁路建设债券发行认购倍数达近17倍。	出台	发行	1
今年3月和8月，我同萨科齐总统两次在北京举行会晤，就双边关系、世界经济形势、二十国集团事务和重大热点问题深入交换意见，进一步提高了两国互信水平。	交换	提高	1
今年3月和8月，我同萨科齐总统两次在北京举行会晤，就双边关系、世界经济形势、二十国集团事务和重大热点问题深入交换意见，进一步提高了两国互信水平。	交换	提高	1
进一步提升互联网行业原始创新、集成创新和引进消化吸收再创新能力，抢占网络传播制高点，形成业务先发优势，培育新兴业态和新的市场需求，延伸拓展产业链，不断增强我国互联网行业的整体实力和核心竞争力。	提升	抢占|形成|培育|增强	1
今年3月和8月，我同萨科齐总统两次在北京举行会晤，就双边关系、世界经济形势、二十国集团事务和重大热点问题深入交换意见，进一步提高了两国互信水平。	交换	提高	1
陈家强表示，中产人士对社会做出重要贡献，对香港多方面发展有很大的承担，行政长官也一再重申政府不会忘记协助中产阶层，今年年初发表的《财政预算案》已提出了多项措施纾缓市民的生活压力，希望多听取议员就议题的意见。	重申政府不会忘记协助|协助	发表|提出|纾缓|听取	1
记者：会议期间，温总理首先将同其他各国领导人全面总结上合组织过去一年来各领域合作进展情况，深入分析当前国际和地区形势，并结合落实阿斯塔纳峰会共识，就本组织下一步工作作出部署和规划。	总结	作出	1
中方将就上合组织发展提具体建议在此次会议期间，温家宝将同有关国家领导人举行双边会见，还将同其他各国领导人全面总结上合组织过去一年来各领域合作进展情况，深入分析当前国际和地区形势，并结合落实阿斯塔纳峰会共识，就本组织下一步工作作出部署和规划。	总结	作出	1
外交部副部长程国平表示，根据各方商谈情况，本次会议预计将取得以下成果：一是就世界和上合组织地区经济形势充分交换意见，形成共同的看法和主 张，并就此发表《联合声明》；二是深入总结上合组织经济、人文合作经验和成果，规划未来工作的重点方向；三是继续推进多方参与、互利共赢的经贸合作，制定 进一步推动项目合作的措施；四是完善组织建设，提高常设机构的工作活力。	交换	形成|发表	1
李克强就国际社会加强资源能源合作提出三点希望，一是应进一步深化开采、加工、技术、市场等全方位务实合作，增强全球资源保障能力。	加强	深化|增强	1
在APEC领导人非正式会议上，胡锦涛将就世界和亚太经济形势阐述中方立场，呼吁完善全球经济治理、加快转变经济发展方式、推进经济全球化和区域经济一体化，并就推进贸易和投资自由化便利化、绿色增长、经济结构改革和规制合作等发表看法。	完善|推进	推进	1
外交部(微博)发言人洪磊昨天就此事回应记者询问时表示，这只是一场普通的渔事案件，中方要求日方切实维护中国船员合法权益。	回应	维护	1
庞之浩：这个项目是2007年中俄签署的一个项目，原定是2009年发射，但是后来由于俄罗斯他们技术方面出现一些问题，推迟到今年发射，像这种火星发射是26个月有一个发射窗口，你要是2009年发射不了，就得2011年发射。	发射	发射|发射	1
新中国成立之初，在医治战争创伤、国民经济初步得到恢复以后，毛泽东同志和党中央就适时地提出了过渡时期的总路线，一边进行社会主义改造，一边开始大规模工业建设，而且实行了优先发展重工业的方针。	提出	进行|开始|实行	1
我国电机工业乃至其他产业要保持良好发展势头，争创世界一流水平，在激烈的国际竞争中掌握主动，就必须继续尊重知识、尊重人才，不断激发人民群众的首创精神，不断激发各条战线上广大工人、技术专家、领导干部的紧迫感、责任感和献身祖国建设事业的使命感。	争创	掌握	1
安监总局要求云南煤矿安监局进一步核清事故情况和被困人数，协助地方政府全力组织抢险救援，科学制定救援方案，千方百计抢救被困人员，严防发生次生事故，并委派正在外地调研的国家安全监管总局副局长、国家煤矿安监局局长赵铁锤，国家煤矿安监局副局长彭建勋立即率员就近赶赴事故现场，督促指导地方做好抢险救援和事故调查等工作。	要求|核清	组织|制定|抢救|赶赴	1
民政部：将建立城乡一体化退役士兵安置制度(权威访谈)扶持就业·多元安置·城乡一体——全国退役士兵安置工作领导小组成员兼办公室主任、民政部副部长孙绍骋解读退役士兵安置改革新华网北京11月11日电(记者卫敏丽)11日，全国退役士兵安置工作领导小组、民政部、总参谋部在京召开会议，学习贯彻党中央、国务院、中央军委关于退役士兵安置改革的重大决策，部署各项改革任务。	建立	解读	1
完善了退役士兵职业教育和技能培训政策，将原来的对自谋职业城镇退役士兵进行短期职业技能培训，调整为对退役1年内的自主就业退役士兵实施免费职业教育和技能培训，退役1年以上参加职业培训的按国家有关规定享受一定优惠，考入全日制普通高等学校的享受教育资助。	实施	参加|享受|考入|享受	1
中国外交部官员说，胡锦涛将在领导人非正式会议上，就世界和亚太经济形势阐述中方立场主张，呼吁完善全球经济治理，加快转变经济发展方式，推进经济全球化和区域经济一体化，并就推进贸易和投资自由化便利化、绿色增长、经济结构改革和规制合作等发表看法。	推进	推进	1
连胜文面对媒体时先澄清，“我没有六个保镖，不要把其他长官的随扈算在我头上”，媒体问再度参加造势场合有阴影吗？	面对|澄清	参加	1
 刘云山一来到中国美术馆，就关切地询问起展览规模和参观情况。	来到	询问	1
 有人放鞭炮 支持特侦组声押陈水扁陈水扁遭声请羁押的消息一传出，台中市第一时间就有民众跑到地方法院前，燃放鞭炮庆祝，还有路人临时加入欢呼行列，大喊司法万岁。	支持|声押|传出	跑到	1
台媒分析，吴淑珍精心挑选两本政论书都有用意，就是要陈水扁记得自己也有过一段“风光的过去”，但陈水扁卸任后因为涉及贪污被收押，台湾民众不禁要问，究竟是谁出卖了台湾？	挑选	收押|出卖	1
不过，这丝毫没有影响到安利大陆游客吃饭心情，这家餐厅老板准备了地道台湾风味菜色，他们还没吃就人手一台摄影机、相机，对着丰富的菜色猛拍，想要留作纪念。	准备	人手台摄影机、相机，对着丰富的菜色猛拍，想要留作	1
肇事方尚未拿出赔偿方案据与会人士介绍，死者家属提出，台北有关方面已经认定工地施工方要负担全部责任，所以应先由肇事方提出赔偿方案，然后再协商赔偿问题。	提出	协商	1
对于两家公司所涉及的刑事责任，台北地检署主任检察官赖正声表示，必须要等到台北市政府劳动检查处调查报告出炉后再予追究，所以，先行给予取保候审或释放。	出炉|追究	给予	1
江丙坤率领的海基会协商代表团25日抵达南京展开两会领导人第三次会谈，在26日就两岸定期航班、两岸金融合作、两岸共同打击罪犯及司法互助等三议题举行了会谈并签署三项协议达成一项共识。	抵达|展开	举行|签署	1
中方支持土耳其在国际和地区事务中发挥更大作用，愿同土方就中东问题、在亚丁湾和索马里海域打击海盗行动加强沟通和协调，在可持续发展、共同应对全球性挑战等问题上相互支持和配合，与国际社会一道，携手建设持久和平、共同繁荣的和谐世界。	打击|加强	建设	1
听说当地政府给刘娟安排了公益性就业岗位，刘娟的女儿前年考上了大学，总书记高兴地对一家人说：“相信你们家的日子一定会越过越好！”	安排	考上	1
在哈尔滨市人力资源市场，胡锦涛走到一个个服务台前，详细了解这个市场开展职业指导和就业服务的情况，同前来求职的大中专毕业生、农民工亲切交谈。	走到	开展	1
“我给你们归纳一下，老师是先告诉你们一个概念，然后启发你们要思索符合这种概念的条件和情况，学会用工具，联系实际加以应用。	告诉	启发你们要思索	1
听了以后，我懂了这堂课其实是开阔学生的思维，用我们经常接触到的一些事情来深究科学原理，提出问题，独立思考，这就需要教师知识非常渊博。	深究	提出	1
为节省时间，吃饭尽量安排在火车上；连续两个晚上主持召开会议，就灾后恢复重建的一系列重大问题进行研究部署。	主持|召开	部署	1
拾级而上，奥巴马一走进太和殿，就对高悬的匾额上书写的“建极绥猷”四个字产生兴趣。	走进	书写的“建极绥猷”四个字产生兴趣	1
“进一步加大棚户区改造力度，让更多困难群众住上新楼房”陕西在推进经济社会发展过程中十分注重做好保障和改善民生工作，棚户区改造就是重点抓的项目。	加大	推进|做好	1
周永康指出，四川地震灾区之所以能够在一年多时间里发生翻天覆地的变化，我国之所以能够成功应对国际金融危机冲击，在全球率先实现经济总体回升向好，从根本上讲，靠的就是中国特色社会主义政治制度，我们要坚定不移地坚持这一制度并随着时代进步不断发展完善。	发生	应对|实现	1
因此，拦水、蓄水、兴修水库就显得特别重要，就需要建设一些控制性骨干水利工程。	兴修	建设	1
2007年7月，第三届特区政府成立之初，行政长官就兑现他的竞选承诺，发表政制发展绿皮书，展开公众咨询，启动新一轮的政改工作。	兑现	发表|展开|启动	1
柯晨辉最后一次回家是7月11日，拿走了2000元钱，说是要给网店进货，母亲没犹豫就给了。	回家	拿走	1
柯晨辉：我们这些人看上去年纪不大，别人也不会害怕我们，所以我们就从网上买来玩具手枪吓唬人，害怕他们认出来是假枪，我们每次都会故意只露出枪的一部分，主要是靠刀子。	买来	认出	1
他将屋内较贵重的财物搬到地势较高的地方后，就在屋内摆放了一辆三轮车，然后坐在床上，看着洪水在门口拍打着门槛。	搬到	摆放|拍打	1
昨日，咸宁水利局专业人士解析：自7月4日入梅以来，咸宁市就连降大暴雨，7月5日平均降雨达50毫米以上，地表基本饱和；8日到14日，咸安区连降大暴雨，淦河流域7天降雨量平均达477毫米，超30年一遇的标准。	降	降雨达50毫米以上，地表基本饱和|连降	1
自温家宝总理在两会上谈到《富春山居图》分藏两岸，并表达希望两幅画能早日合成一幅画的愿望后，这幅画就牵动着两岸人民的心。	合成	牵动	1
饱览群书的李戡选择经济学院就读，而没有选择其家学渊源颇深的人文、历史学科，李戡说，那些只是兴趣，而他要选择一门需要刻苦钻研的学科。	选择	选择	1
希望双方进一步发挥中智议会政治对话委员会的作用，就共同关心的问题深入对话，交流治国理政经验，为中智全面合作伙伴关系注入新的活力。	发挥	深入对话|对话	1
北监发言人吴信彦表示，这项作法是要让每个受刑人都得到适当处遇，可以安心服刑；只要有需要，北监就会采取各种措施，随时因应，处遇措施不是一成不变，更不是特权。	采取	因应	1
只要有需要，台北监狱就会采取各种措施，随时因应，处遇措施不是一成不变，更不是特权。	采取	因应	1
其它交通配套包括巴士站及旅游巴停泊区，以及位于石排湾工业村对开的临时公众停车场已准备就绪，合共提供约二十一个旅游巴位、三百多个私家车位及六十多个电单车位。	准备	提供	1
不过，台北监狱方面表示，一切都会尊重医师的专业来判断，至于身体检查部分也需要进一步跟医院来联系及安排；至于戒护就医，台北监狱人员则表示，一切都会依照相关的规定处理。	尊重|判断	安排	1
总理了解情况后，郑重地对她说，城镇房屋拆迁，第一应该依法进行；第二应该对业主受到的损失给予合理补偿；第三应该进行深入细致的思想工作，让群众了解拆迁的需要，从而自愿协助政府工作。	进行	补偿	1
鉴于拦路讨红包者身份难认定，陈光标决定将捐款委由慈善基金会处理，不再现场发红包，惹争议的斗大红心识别胸牌，“光标爱心团”成员们昨日不再配戴，就连两名随团摄影师也被责令立即离台，凡是造成台湾民众反感的，陈光标一律从善如流。	责令	造成	1
鉴于拦路讨红包者身份难认定，陈光标决定将捐款委由慈善基金会处理，不再现场发红包，惹争议的斗大红心识别胸牌，“光标爱心团”成员们昨日不再配戴，就连两名随团摄影师也被责令立即离台，凡是造成台湾民众反感的，陈光标一律从善如流。	责令	造成	1
温家宝深入大别山与民众共迎春节(组图)中广网金寨2月2日消息 (记者 肖志涛) 2月1日，农历腊月二十九，中共中央政治局常委、国务院总理温家宝刚刚出席了在北京举行的中共中央、国务院2011年春节团拜会，就直接飞赴安徽合肥，深入革命老区大别山，走村进户，看望农民群众，到金寨县梅山水电站职工宿舍小区慰问干部职工，同大家一起喜迎新春佳节。	飞赴	深入|看望|慰问|喜迎	1
法国首位女驻华大使将于3月6日赴京就职(图)自去年11月底，法国驻华大使苏和卸职返回巴黎后，该职一直处于空缺状态。	赴京就职	卸职|返回|处于	1
经过各方幕后一番激烈角逐，最终是资深中国问题专家西尔维·贝尔曼(Sylvie Bermann)女士胜出，并将于下个月赴北京就职。	角逐	胜出	1
高孔廉指出，此次海协会经贸团中，有20多位重量级的企业老板，他(她)们也在交流中找到了一些商机，相信很快就会变成具体的合作项目并落实。	找到	变成|落实	1
不过，马英九表示，今年纪念二二八事件与过去不一样的就是他推动建议多年的二二八纪念馆正式运作。	纪念	推动|运作	1
就在花莲于5日晚间连续发生七起地震后，6日又有苗栗渔民在竹南近海捕获一条3.5米的皇带鱼(俗称地震鱼)，引发民众联想。	发生	捕获	1
对此，买下该尾皇带鱼的餐厅主厨表示，深海鱼通常是因为海底发生地震等地质变动，受到惊吓才会改变栖息环境，游到浅水海避难，不过是否日本地震有所关联，就不得而知。	受到|改变	避难	1
清华园里，一幢幢庄重典雅的老校舍诉说着历史，一座座富有创意的新校舍闪动着希望，赶回母校的年长校友、正在就读的年轻学子用一阵阵欢声笑语把校庆气氛烘托得格外浓郁……	闪动	赶回|烘托	1
胡锦涛希望清华大学以建校百年为新的起点，全面贯彻党的教育方针，坚持教书育人，进一步提高教学质量和科研水平，努力跻身世界一流大学行列，为国家富强、民族振兴造就更多优秀人才、提供更多智力支持，不断谱写清华大学新的辉煌篇章。	跻身	提供	1
中央对水利事业一直高度重视，今年专门就新形势下加快水利改革发展发了1号文件。	重视	加快	1
胡锦涛这次考察的北辰区秋怡家园就新建有1300多套公共租赁住房，一些中低收入家庭已经入住。	考察|新建	入住	1
(中国台湾网 冯存健)蔡冠伦小档案存殁：1941—2011年，享寿70岁绰号：蔡老大学历：毕业于台空军官校，曾当飞行官经历：1955年 加入第一代四海帮1985年 “一清专案”被送绿岛管训3年1992、1995年 两度参选民意代表落败1996年 治平项目再被移送绿岛管训2007年 与名导侯孝贤结亲家2010年 70大寿当天因涉“组织犯罪条例”等罪嫌遭警逮捕	加入	移送	1
温总理说，他认为，只要有信心和勇气，就一定能够处理好核事故，一定能够重建美好的家园。	处理	重建	1
我说过慈善一定要落地，所谓落地，就是要深入、融入这块土地、人群、文化， 这才叫落地。	落地	落地|融入	1
马西莫夫表示，胡锦涛主席同纳扎尔巴耶夫总统进行了非常成功的会谈，两国元首就发展两国全面战略伙伴关系、推进双边务实合作规划蓝图，达成一系列重要共识。	推进	达成	1
吴康民指，1996年他70岁时，正值其母亲方静娴逝世60周年，为纪念先母他捐出20万人民币，经友人介绍，在广州增城福和镇南池村兴建一所希望小学，命名“方静娴纪念小学”，之后交由当地政府营运。	捐出	兴建|营运	1
他在校门前遇上曾就读的学生，指学校两年前已停办，学生并入另一镇内小学。	遇上	停办|并入	1
乡村学生减少 诸多希望小学被“撤并”明报在另一篇报道中表示，香港慈善团体苗圃行动指出，由于内地人口急速变化，民工带子女由乡入城，乡村小学随着学生减少，偏远地区旧式平房学校被整合，多数学生到镇中心小学就读。	减少	变化|减少	1
这次，我带来了中央政府关于支持香港进一步发展，深化内地与香港经贸金融等方面合作若干新的政策措施，明天我在论坛上还将就此进行阐述。”	带来	深化内地与香港经贸金融等方面合作若干新的政策措施，明天我在论坛上还将此进行阐述|阐述	1
他输入《深圳之路》一书的编号，服务机的借书口很快就送出了这本书。	输入	送出	1
但是，只要奶业企业、奶业职工和农业部门下定决心，共同努力，攀登高峰，就一定能够实现这个目标。”	攀登	实现	1
但是，只要奶业企业、奶业职工和农业部门下定决心，共同努力，攀登高峰，就一定能够实现这个目标。”	攀登	实现	1
马英九昨晚表示，“我没有去探望，因为这时候不宜打扰，(我去)就是了解一下病情”。	打扰	了解	1
据悉，此次火星探测不仅是我国第一个进入火星轨道的探测器，也是俄罗斯时隔多年之后第一次重返火星。	进入	重返	1
如果这些血凝块中的一块阻塞大脑动脉，就会发生中风。	阻塞	发生	1
人体被疯狗咬伤后，理想的治疗方法是先清洗伤口，注射抗体来中和狂犬病毒，然后再使用狂犬疫苗来激活人体免疫系统。	治疗方法是清洗|清洗	注射|中和|使用|激活	1
专家工作组会议调查了国内外200多篇文献，认为克隆牛“出生后成长约6个月后就会和普通牛一样健全发育”，不存在安全问题，对克隆猪也做出了同样结论。	调查	做出	1
据最新一期的美国《预防》杂志报道，近日，美国资深健身专家克莉斯·弗雷塔格创立了一种新的健身方法，让人们每次只花短短10分钟就能快速减肥。	创立	减肥	1
结果表明，受试女性都能一下子就找出爱侣的衣服。	下子	找出	1
美国众院将就沙门氏菌疫情举行听证会新华网华盛顿1月29日电（记者任海军）来自加利福尼亚州的美国民主党籍众议员、众议院监督和政府改革委员会主席亨利·韦克斯曼29日宣布，美国众议院将针对美国目前的沙门氏菌疫情召开一次听证会。	举行	召开	1
研究人员先给实验鼠注射达菲，两小时后再注射感冒药中常见成分咖啡因和麻黄碱。	注射	注射	1
另外，其他国家的被试验对象其基因特点和医疗卫生条件与美国本国人也有不同程度差别，所以新药产生的药效及副作用等也不一样，最后投入美国国内临床使用就存在诸多隐患。	产生	投入	1
纽约西奈山医学院教授皮特·帕莱塞等专家评论说，这种血凝素堪称“病毒的阿喀琉斯之踵”，一旦破除这层“伪装”，抗体就能“直捣黄龙”。	破除	直捣	1
美国科学家研究发现，通过检测血液中一种特定分子的水平，就可以对药物引发的肝中毒提前预警。	检测	预警	1
然后，仅凭借检测老鼠血液中“微ＲＮＡ”（一种小分子核糖核酸）水平，就可以判断出哪只老鼠出现肝中毒。	检测	出现	1
塞拉-孔戴也在回复给美联社的邮件中说，女性评判看到的某一事物时，倾向于找出适当的词语描述它，而男性的脑海中往往浮现的就是这一事物的具体形象。	评判	找出|描述	1
硫化氢气体有助于阴茎勃起的研究借鉴了早期另一种气体的发现过程，也就是一氧化氮参与了类似的生化过程，而也正是此一发现导致了阳痿治疗药物万艾可的出现。	借鉴	参与	1
女孩常见的错误认识，就是“好女孩不应该渴望与享受性爱”，这容易使她们在性要求方面自我封闭，时间一长容易导致性冷淡。	渴望与享受|享受	封闭|导致	1
未勃起就戴套，容易脱落美国伯明翰阿拉巴马大学研究人员曾对1100多名男女进行过调查，发现有将近1/4的人，在最近一个月内错误地使用了安全套，如戴上安全套之前就将套体完全展开，女性为伴侣戴安全套时没有将顶端的空气放尽，男性自己使用安全套时将里面一层翻在外面戴。	使用	戴上|展开	1
34岁居民何塞·路易斯·马丁内斯告诉美联社记者，当他第一次听到疫情暴发的新闻，得知猪流感症状为发烧、咳嗽、剧烈头痛、呕吐腹泻时，他就知道疫情实际上发端于拉格洛里亚村。	听到	发端	1
根据英国学者研究表明，在两性节律日这天，如果男女相会彼此往往一见钟情，相爱的男女幽会就会激情荡漾。	相会	幽会	1
此外，世卫发言人哈特尔说，如果美国证实猪流感病毒已在人与人之间广泛传播，这也就是说该病毒已经在两个国家的人群中传染，那么世卫就会进一步将全球流感疫情警戒等级提高到第五级。	传染	提高	1
1、去医疗机构之前，应该首先与医护人员进行联系，报告自己的症状，解释为何会认为自己感染了甲型H1N1流感，例如自己最近去过暴发这种流感的某个国家，然后听从医护人员的建议；2、如果没法提前与医护人员联系，那么当抵达医院寻求诊断时，一定尽快把怀疑自己感染甲型H1N1流感的想法告知医生；3、去医院途中，用口罩或其他东西遮盖住嘴和鼻子。	联系	报告|感染|听从	1
相反，第一次约会如果没能打动一个女人，随后她就会消失，并且从此杳无音信。	打动	消失	1
近日，美国著名男性网络杂志“问他”就给出了一系列能有效提高性能力的运动方式，并详细解释了每一种方法的益处。	给出	解释	1
英国专家指出甲型流感病毒出现抗药性中新网6月30日电 据英国广播公司报道，就在英国出现第3个甲型H1N1流感死亡病例的同时，有专家指出一些接受治疗的病者体内的病毒已经对治疗流感主要药物达菲(Tamiflu)呈现抗药性。	出现	接受|呈现	1
人脑中有一个松果体腺体，它可以分泌一些激素，使人的睡眠时间增长，老年人松果体腺功能衰减，所以一大早就睡不着。	分泌	增长|衰减	1
如果这一平衡遭到破坏或者某一方衰退就会发生病变，男性会出现阳痿、早泄、滑精等病症。	遭到|破坏	发生	1
调查中，40%多的受访者在婚前没有同居经历，16%的人先订婚后同居，另有43%的人恋爱后很快就搬到一起。	订婚后同居|同居	恋爱	1
结果显示，没有订婚就同居的人，其婚后满意度最低，出现负面情绪的几率最高，且动过离婚念头的次数最多，并有19%的人提出过离婚；而这一比例在订婚后同居者中为12%，在结婚前未同居的人中仅为10%。	订婚就同居|同居	出现|动过离婚念头的次数最多，并有19%的人提出|提出	1
为了避免体重增加，最重要的就是要摄入足够的高质量蛋白质，比如瘦肉、禽肉和鱼，但是一定不能多吃。	摄入	多吃	1
肿瘤研究人员通过检测发现，半数女性体内含有一种特殊基因，因为这种基因，当她们摄入咖啡因时，乳房就会缩小。	含有	摄入|缩小	1
早上梳妆打扮的时候，别忘随意摇动一下身体，半个小时的摇动就可以消耗30卡路里。	摇动	消耗	1
看书、电视、电脑1—2小时，就应该起身活动一下，做一做颈椎保护操：背靠在椅子靠背上，将头自然向后仰上几分钟；或两手交叉放在头后，让头缓慢地往后仰，双手用力往前推，使头手较劲。	起身活动|活动	仰上	1
早在2007年，该研究小组就成功地将一种细菌的基因移植到另一种细菌中，第二种细菌后来果然长成了第一种细菌。	移植	长成	1
研究人员发现，在天然细菌基因移植中，基因会经过一个甲基化(m ethylation)的过程，当基因被移植到别的细胞中后，经过了甲基化的基因就不容易受到别的细胞中某些物质排斥性的“攻击”。	经过	移植|受到	1
从传统的疾病发生、发展和流行规律来看，一种新的病毒出现以后，它的发展方向就是三个：一个就是它的情况逐渐加重，危害逐渐加重，造成广泛的传播流行，甚至造成比较高的病死率。	出现	发展	1
美国国务院在当天的声明中表示，伯恩斯将于10月24日在得克萨斯州A＆M大学就美中关系发表演讲，然后他将于本月26日至29日先后访问日本和中国。	发表	访问	1
兵役法修正案草案退役军人报考公务员优先录用中新社北京10月24日电 (记者 周兆军)中国全国人大常委会24日第二次审议兵役法修正案草案。	报考	审议	1
但是现在确实有一个信息不是特别清楚的问题，我们正在努力建设城镇个人住房信息系统，这个信息系统的建设老实说很艰难，我们准备先在四十个城市进行试点，试点的进程是先把四十个城市自身个人的住房信息收集起来，然后尽快实行全国的联网。	收集	实行	1
也正是因此，神八升空之后的控制动作将非常的密集，在今天中午12点左右，神八运动到第五圈届时将进行第一次轨道控制，抬升它的近地点高度。	控制	进行|抬升	1
在中国日前先后出台“铁路建设债券利息收入企业所得税减半征收”、“明确铁路建设债券为政府支持债券”等政策作用下，市场对铁道部债券信心和认可度大幅上升，10月26日铁道部第二期200亿铁路建设债券发行认购倍数达近17倍。	出台	发行	1
进一步提升互联网行业原始创新、集成创新和引进消化吸收再创新能力，抢占网络传播制高点，形成业务先发优势，培育新兴业态和新的市场需求，延伸拓展产业链，不断增强我国互联网行业的整体实力和核心竞争力。	提升	抢占|形成|培育|增强	1
连胜文面对媒体时先澄清，“我没有六个保镖，不要把其他长官的随扈算在我头上”，媒体问再度参加造势场合有阴影吗？	面对|澄清	参加	1
肇事方尚未拿出赔偿方案据与会人士介绍，死者家属提出，台北有关方面已经认定工地施工方要负担全部责任，所以应先由肇事方提出赔偿方案，然后再协商赔偿问题。	提出	协商	1
对于两家公司所涉及的刑事责任，台北地检署主任检察官赖正声表示，必须要等到台北市政府劳动检查处调查报告出炉后再予追究，所以，先行给予取保候审或释放。	出炉|追究	给予	1
“我给你们归纳一下，老师是先告诉你们一个概念，然后启发你们要思索符合这种概念的条件和情况，学会用工具，联系实际加以应用。	告诉	启发你们要思索	1
总理了解情况后，郑重地对她说，城镇房屋拆迁，第一应该依法进行；第二应该对业主受到的损失给予合理补偿；第三应该进行深入细致的思想工作，让群众了解拆迁的需要，从而自愿协助政府工作。	进行	补偿	1
(中国台湾网 冯存健)蔡冠伦小档案存殁：1941—2011年，享寿70岁绰号：蔡老大学历：毕业于台空军官校，曾当飞行官经历：1955年 加入第一代四海帮1985年 “一清专案”被送绿岛管训3年1992、1995年 两度参选民意代表落败1996年 治平项目再被移送绿岛管训2007年 与名导侯孝贤结亲家2010年 70大寿当天因涉“组织犯罪条例”等罪嫌遭警逮捕	加入	移送	1
吴康民指，1996年他70岁时，正值其母亲方静娴逝世60周年，为纪念先母他捐出20万人民币，经友人介绍，在广州增城福和镇南池村兴建一所希望小学，命名“方静娴纪念小学”，之后交由当地政府营运。	捐出	兴建|营运	1
据悉，此次火星探测不仅是我国第一个进入火星轨道的探测器，也是俄罗斯时隔多年之后第一次重返火星。	进入	重返	1
人体被疯狗咬伤后，理想的治疗方法是先清洗伤口，注射抗体来中和狂犬病毒，然后再使用狂犬疫苗来激活人体免疫系统。	治疗方法是清洗|清洗	注射|中和|使用|激活	1
研究人员先给实验鼠注射达菲，两小时后再注射感冒药中常见成分咖啡因和麻黄碱。	注射	注射	1
1、去医疗机构之前，应该首先与医护人员进行联系，报告自己的症状，解释为何会认为自己感染了甲型H1N1流感，例如自己最近去过暴发这种流感的某个国家，然后听从医护人员的建议；2、如果没法提前与医护人员联系，那么当抵达医院寻求诊断时，一定尽快把怀疑自己感染甲型H1N1流感的想法告知医生；3、去医院途中，用口罩或其他东西遮盖住嘴和鼻子。	联系	报告|感染|听从	1
早在2007年，该研究小组就成功地将一种细菌的基因移植到另一种细菌中，第二种细菌后来果然长成了第一种细菌。	移植	长成	1
根据出现症状的年龄段，研究人员将他们分成3组：第一组从小患有牙科焦虑症，第二组是青少年时期开始出现牙科焦虑症状，另一组则在成年后才患上牙科焦虑症。	患有	出现	1
在这项研究中，研究人员将平均年龄60岁的成年人分成三组：第一组在饮食中要限制热量摄入，将摄食量降低30%左右；第二组坚持相同的饮食习惯，不过食物中不饱和脂肪含量更高；第三组则没有对饮食做出任何改变。	限制	降低|坚持	1
 瑞典乌普萨拉大学医院的研究人员报告说，他们在10多年前对930名70岁以上老年男子进行了一次简单测试，让后者以用笔画线的方式把不规则分布在一张纸上的数字从小到大连接起来，然后再把随意分布的字母按字母表上的先后顺序连接起来。	连接	连接	1
泡发香菇时，可先用水将其表面的尘土冲掉，再放入适量温水中浸泡约一小时，然后用手指朝着一个方向搅动或是将香菇的蒂部朝下在水中抖动，使其中的泥沙沉入碗底。	冲掉	浸泡	1
在第一个实验中，第一组志愿者观看一个有关大自然的录像，第二组志愿者则观看一个宣传他人做好事的录像。	观看	观看	1
随后，研究人员询问志愿者是否愿意参加一次公益活动，结果第二组中做出积极回应的比例高于第一组。	参加	做出	1
试验人员先是通过言语激怒受试者，几分钟后再对其道歉。	激怒	道歉	1
朱江明：恐怖袭击下的生存术-朱江明为避免被恐怖分子所伤，需要先判断正确的逃生路线和时机，寻找合适的掩蔽处印度孟买发生的恐怖事件再次让世人震惊，原来街头子弹横飞的场景并不一定发生在伊拉克或者阿富汗。	判断	发生	1
据他说，Fed的看法与市场主流观点是一致的：第四季度和明年第一季度都会持续疲弱，之后会好转。	持续	好转	1
二是，一旦美国零利率格局被市场消化，套息交易的再度猖獗一定会给中国经济带来两大方面的压力：首先是企业将面临又一轮美元贬值所带来的人民币增值的挑战。	消化	猖獗|面临	1
基廷的回答很简单，先是确认中美两国的防务对话确实中断了，而他所在的美军太平洋指挥部很可能是这一对话的最主要参与者之一，然后表示自己希望这一对话能在不久的将来得到恢复，他并且对此抱“谨慎乐观的态度”。	中断	恢复	1
先制止流血，再寻找正义；先得到和平，再辩论是非。	制止	寻找	1
他说，乌方此举具有挑衅和破坏性质，俄方恢复过境乌克兰对欧洲输气必须满足两个条件：第一、俄罗斯、欧盟和乌克兰最终签署的议定书必须与俄方拟制、商定、签署的议定书完全相符；第二、观察员要实际就位，抵达将展开监测工作的乌克兰边境相关地点和该国地下储气库。	签署	就位	1
“橙色联盟”再次破裂后，乌总统尤先科和总理季莫申科面对越来越近的总统大选都希望能主导天然气问题，同时在这个问题上给对方下绊子。	破裂	主导	1
发生了一个叫金旺子的韩国妇女在金刚山旅游区被枪击死亡事件；朝方先后宣布中止金刚山、开城工业园区的旅游项目，继而宣布大幅度减少开城工业园区，南方人员接着宣布中断才恢复不久的南北铁路通行；到2008年12月1日，朝方宣布中断双方在军事分界线的往来；今年1月17日和1月30日的声明，更使南北关系紧绷到战争的边缘，似乎战争一触即发。	宣布	宣布|减少|宣布	1
原因是他提名的内阁成员一再陷入“逃税门”事件，先是盖特纳，现在是克勒夫(Nancy Killefer)及其“政治导师”达施勒，虽然前者侥幸过关，但后两者却被迫撤回提名。	陷入	撤回	1
类似的擦边球保护主义在美国绝非独此一家，同样在这个刺激方案中，还有参议员提出附加“雇佣美国人”条款，即300多家正在接受政府援助的美国银行在需要增加雇员时，必须优先考虑雇佣美国人，之后才能考虑雇佣外国人；银行若为外国雇员申请签证，之前三个月和之后三个月均不得辞退或替换美国员工。	雇佣	雇佣	1
从卡特开始，历任美国总统履新时，一般都会先就贸易、人权和台湾等问题对中国政府横加指责，然后逐步过渡到友好合作的正常状态。	指责	过渡	1
邓聿文：金融海啸第二波是否即将上岸作者：邓聿文提要 与其说是第二波金融海啸即将到来，还不如说是金融危机的深化，而我们更需关注的是中国面临第一次真正意义上的生产过剩所发出的危机信号。	到来	深化	1
从美国次贷出现问题以来，我们看到，危机先是在次贷市场引爆开来，紧接着是金融业陷入危机，再接着是经济出现衰退，各行各业走入萧条，最后可能引发社会危机。	引爆	陷入	1
(作者系《学习时报》副编审)来源：上海商报作者：邓聿文提要 与其说是第二波金融海啸即将到来，还不如说是金融危机的深化，而我们更需关注的是中国面临第一次真正意义上的生产过剩所发出的危机信号。	到来	深化	1
从美国次贷出现问题以来，我们看到，危机先是在次贷市场引爆开来，紧接着是金融业陷入危机，再接着是经济出现衰退，各行各业走入萧条，最后可能引发社会危机。	引爆	陷入	1
但我们都不会忘记，一再宣扬要与世界同舟共济、要与其他国家共同应对金融危机的奥巴马政府，不久前曾扬言救市资金“要优先保证美国公民的工作”，并且规定一些基础设施建设必须采用美国产钢材。	宣扬	扬言|规定|采用	1
在上面举的例子中，要降低风险，交易者会同时出售两种期权，他们认为当第一种的价格上升时，第二种的价格很可能会下降，因此在前者的交易赔本，在后者的交易却会赚钱，这是hedging(对冲)。	上升	下降	1
“德国之声”就送给中国一顶大高帽，其署名文章说，德国智库“德国外交政策协会”在政商学界的精英人士中进行的一项问卷调查显示，88%的被调查者认为，中国将在20年之后超过美国成为世界第一经济大国；76%的人认为，20年后中国将保持仅次于美国之后世界第二大政治强国的地位。	超过|成为	保持	1
此后一周的时间里，奥巴马的行程可谓紧凑频密：首先是4月1日会见英国首相布朗；接着是4月2日出席G20峰会，其间与中国国家主席胡锦涛及各国政要见面；然后周末飞赴法国斯特拉斯堡参加北约会议，接着是出席5日在捷克首都布拉格召开的欧盟美国峰会；6日转赴土耳其首都安卡拉，开始其对第一个伊斯兰国家的访问，7日又闪电访问伊拉克后返回美国。	会见|出席	见面|飞赴|参加	1
这三个国家同时还是世界上少有的拥有巨额外汇储备的国家，中国拥有近2万亿美元居世界第一，日本拥有1万亿美元居世界第二，韩国外汇储备曾经居世界第五位。	拥有	拥有	1
而美国为了优先考虑自身的问题，暂时将传统理念和政治搁置一边，奥巴马将中国提升为亚洲的优先伙伴，日本的地位降为第二。	提升	降为	1
人类有个永远乐此不疲的游戏：先塑造一尊神，再以把他们一脚踹下神坛为乐，踩出人命之后，又修一座更宏伟的神坛供奉起来，每个人都在口水中获得了满足。	塑造	踹下	1
1899年第一台欧宝在德国诞生，1914年夺德国汽车销售王座，1931年被通用收购成为通用第二大品牌，今年5月29日被加拿大麦格纳集团收购。	诞生	收购|成为	1
加拿大第一大报《环球邮报》汽车版7月24日发表重头文章《豪华轿车在英国的再造之旅》，全面介绍英国汽车王牌捷豹以及路虎卖给印度塔塔集团之后的新生。	发表	卖给	1
此后，俄罗斯先是卷入第一次世界大战，接着内部发生十月革命，苏联建立，随之又是第二次世界大战。	卷入	发生	1
先有墨尔本电影节不顾中国反对执意播放美化热比娅的纪录片，继而澳政府也无视热比娅的罪行给其发放签证，紧接着澳政客就口出狂言，公然宣扬要帮助热比娅“解放东突厥斯坦”。	播放	无视|发放|口出	1
今年朝核问题陷入了僵局，朝鲜先是发射了一颗所谓“光明星二号”卫星，紧接着第二次进行了地下核试验。	发射	进行	1
先是巴蒂尔休战一个月，接着去夏实施了两处手术的麦迪一直没好利索，与阿泰是打打歇歇，到了2月麦迪终于支撑不住，只好再施手术赛季早早报废。	休战	实施	1
好不容易打进季后赛并12年来首度实现首轮突破，先是队内第二高度、姚明替补穆托姆博因膝伤宣布退出ＮＢＡ，接着在与湖人交手关键时仅剩的球队核心姚明又突现脚伤而告别赛季，一支旨在升空的火箭队瞬间变为了全联盟草根一族。	宣布|退出	交手|突现|告别	1
先是巴蒂尔休战一个月，接着去夏实施了两处手术的麦迪一直没好利索，与阿泰是打打歇歇，到了2月麦迪终于支撑不住，只好再施手术赛季早早报废。	休战	实施	1
好不容易打进季后赛并12年来首度实现首轮突破，先是队内第二高度、姚明替补穆托姆博因膝伤宣布退出ＮＢＡ，接着在与湖人交手关键时仅剩的球队核心姚明又突现脚伤而告别赛季，一支旨在升空的火箭队瞬间变为了全联盟草根一族。	宣布|退出	交手|突现|告别	1
作为世界杯全球赞助商嘉实多(Castrol)的形象大使，阿森纳主教练第一次来到中国，第二天就在以“鸟巢”为背景的这片绿茵场上开班授课。	来到	开班	1
先到健身房锻炼半小时，然后比所有同事都更早地开始工作。	锻炼	开始	1
他表示，来自三军的防御武力将分成两组，第一组监督各地点的抗议群众，第二组防范民盟与拥政府派的冲突。	监督	防范	1
卡钦斯基说：“而其他说法(声称俄罗斯已经履行协议)则出自于特定的哲学逻辑：第一是向俄罗斯让步；第二是向俄罗斯让步；第三还是向俄罗斯让步。	让步	让步	1
据警方表示，攻击事件首先发生在外国观光客出入频繁的泰姬玛哈旅馆外面，不明份子以自动武器射击在旅馆外的警察和安全人员，然后冲入旅馆大厅进行扫射攻击。	出入	射击|冲入|进行	1
唐纳森说，那架飞机进行了第一轮攻击后，调整好位置，又进行了第二轮攻击，他的双腿均被子弹击中。	进行	调整|进行	1
白岩松：对，但是今天宣布对此负责的组织出来之后，马上就会说他提出两个要求，第一个要求是要求释放被关押的“圣战者”，第二个是印度不要对伊斯兰教施以这么严格的打压。	释放	打压	1
自从2001年美国发动了阿富汗战争后，驻阿美军及北约部队所需要的大量后勤物资主要依靠陆路进行运输：各类物资首先要通过海运抵达巴基斯坦南部港口卡拉齐，然后就被装入没有任何标识的普通集装箱内，由大卡车经山口送入阿富汗境内。	抵达	装入	1
近期美哈军事关系积极发展与几个因素有关：第一，新当选总统奥巴马准备把驻阿美军人数增加至2万人，这些兵力需要通过空中运送，而美国驻吉尔吉斯马纳斯空军基地的转运资源不足；第二，美国新政府加强了对中亚国家的攻势，排挤俄罗斯和中国。	发展	准备|增加|运送	1
这是他担任俄罗斯总统以来首次访问印度，也是孟买恐怖袭击之后第一位访问印度的外国元首。	担任|访问	访问	1
他以医院接到一个病入膏肓的病人为例，首先就是紧急为这个病人输血，先稳定他的生命，然后再协助他恢复健康。	稳定	协助他恢复|恢复	1
被问到政府是否应对三大汽车厂商伸出援手时，奥巴马先批评三大车厂一再重蹈策略错误，二十年前就应该改革的事情，至今未改。	批评	重蹈	1
集会者在活动开始前先为伊拉克前总统以及所有在美国领导的国际联军发动军事行动以来死亡的伊拉克人默哀1分钟，然后奏响了萨达姆统治时期的国歌和军歌。	发动	奏响	1
包括油类在内的非致命补给品将首先通过黑海运往格鲁吉亚，再经阿塞拜疆运往土库曼斯坦，最后运往阿富汗边境。	运往	运往	1
英国伦敦在2012年夏季奥运会的举办权争夺大战中先后战胜了俄罗斯莫斯科、西班牙马德里和法国巴黎，在国际奥委会第117次会议上最终胜出，但是现在英国人已经不再为此胜利而喜悦，主要原因就是筹办费用成倍增加，面临资金短缺的严峻压力。	战胜	胜出	1
奥巴马团队的经济学家已假定在第一年投入6000亿美元，第二年投入3000亿至6000亿美元，然后再视2010年的经济情况而定。	假定|投入	投入	1
她患有一种罕见的先天性侏儒症——软骨发育不全症，身高不会再增长。	患有	增长	1
在得到多数议会党团领袖支持后，俄总统随即向国家杜马提交了新宪法修正案，数日后议会下院和上院先后表决通过，然后根据宪法要求提交地区议会表决。	表决通过	提交	1
乌克兰总统反对议会橙色联盟中国网12月18日讯，据俄罗斯《观点报》报道，乌克兰总统和总理之间的权力斗争近日再掀新篇章，在季莫申科成功重建议会橙色联盟保住总理宝座之后，尤先科总统班底指责她是国家政治和经济危机的“罪魁祸首”，呼吁女总理立即辞职。	重建|保住	指责|辞职	1
根据以色列军方的说法，以军27日首先派出50架战机，向50个目标投掷100枚炸弹，目标包括哈马斯基地、训练营、总部、办公室；30分钟后，60架战机再向60个目标袭击，目标包括收藏于地下碉堡的火箭发射器。	派出	投掷|袭击	1
主持人：我们和阿鲁夫先生连线的信号临时的中断了，我们想大家也可以理解，因为目前在加沙地带以色列的空袭还在持续，今天进入到第三天还是有不断的最新的报道，所以那儿的信号的稳定度肯定是非常的糟糕，那我们等会儿还会继续再进一步的跟他来连线。	中断	持续|连线	1
有时候，他们会事先投下响声炸弹，以便让居住那里的平民赶紧离开，然后才进行强有力的导弹袭击，直到将这些建筑物夷为平地。	投下	离开|进行	1
报道称，阿米蒂奇认为布什政府属于“牛仔政权”，尽管第二任时改为多国协商路线，但第一任时的布什、副总统切尼、总统助理赖斯等都认为外交是弱者的表现，想向对方展示强大的实力，总觉得不依靠实力解决问题就不是牛仔。	改为	认为|展示	1
 《泰晤士报》报道说，一名哈马斯高级成员披露了哈马斯是如何改变发射火箭弹的战术来逃过以军空袭的：哈马斯成员原先使用车辆来发射火箭弹，但在以军无人机、战斗机和直升机对加沙空域巡逻的情况下，哈马斯改变了战术，武装人员开挖地道，然后布下很长的引爆线，远距离发射火箭弹。	使用|发射	巡逻|改变|开挖|布下	1
去年12月27日，以军开始代号为“铸铅”的军事行动，当天首先派出50架战机，向50个目标投掷100枚炸弹，目标包括哈马斯基地、训练营、总部、办公室；30分钟后，60架战机再向60个目标袭击，目标包括收藏于地下碉堡的火箭发射器。	派出	投掷|袭击	1
哈马斯成员原先使用车辆来发射火箭弹，但在以军无人机、战斗机和直升机对加沙空域巡逻的情况下，哈马斯改变了战术，武装人员开挖地道，然后布下很长的引爆线，远距离发射火箭弹。	使用|发射	巡逻|改变|开挖|布下	1
从以色列的角度来说，它完成了第一阶段，采用空袭等等战术之后，它要师出有名，因为它师出有名的目的就是你哈马斯不断地在用火箭弹力袭击我的百姓，因此它就要通过地面战来完成一个重要的使命，就是我在你加沙的北面打出一个隔离带来。	完成	采用	1
欧洲天然气工业的资深业内人士抱怨道，“欧盟官员混淆了政治需要与经济、商业和能源基础的关系，通常的做法应该是先找到资源然后再建立管道，然而纳布科却是反向操作。”	找到	建立	1
国际红十字会在声明中呼吁，以色列和哈马斯武装人员应立即停止对民用设施的任何军事攻击行动，首先让平民远离战火至关重要，然后必须对遭受战火伤害的平民进行有效的医治。	远离	医治	1
国务卿赖斯解释说，美国原本希望先看到埃及的调解努力所取得的成果后，再由安理会通过相关决议，因此在表决中投了弃权票。	看到	通过	1
俄罗斯的媒体认为，他首先从国际政治上俄罗斯要反击北约东扩，从事打压乌克兰和其他独联体国家他们这种离心倾向，另外从国际经济上来说，他也是希望通过这次向乌克兰施压，能够完成对整个天然气管线的掌控，然后拥有该地区的天然气定价权，并且通过这种手段来挽回国际能源市场下跌的颓势。	反击	打压|施压|拥有	1
在完成了抢劫船只的原始积累之后，富有的海盗远比贫穷的索马里政府军更有实力去购买先进的武器装备。	完成	购买	1
据悉，哈立德在庭审过程中首先试图把美国军方为其指定的律师赶下辩护席，然后就开始指责法官限制了他的言论自由。	赶下	指责|限制	1
第一夫人米歇尔当日身穿破格的柠檬绿套装出席就职礼，赢得时装界赞誉；晚上再换上一袭纯白雪纺晚装，与丈夫领跳第一舞，艳压全场。	身穿|出席	换上	1
朝中社20日播发的一副照片显示，在平安南道安州市南星青年化学联合企业，工人阶级得悉朝鲜人民军总参谋部发言人发表的声明之后，在建设工地举行集会，声讨李明博政府的反朝对抗政策，朝中社的图片说明说，工人们“决心化愤怒为革命热情，以更大的生产成果掀起‘不败的先军朝鲜’的新高潮”。	发表	举行|声讨|掀起	1
加央行还预计，加经济增长将会面临连续三个季度的下降，去年第四季度下降百分之二点三，今年第一季度下降百分之四点八，接下来还会下降百分之一。	下降	下降	1
他1945年之后逃到南美，先躲藏在阿根廷和巴拉圭，后来在巴西落脚，直到1979年68岁时游泳溺毙，一直逍遥法外。	逃到	逍遥	1
据报道，小偷先是敲碎了房间玻璃进入公寓，然后将贵重财物洗劫一空。	敲碎|进入	洗劫	1
西班牙国家警察部门一名官员说，犯罪嫌疑人在本案中的欺诈模式是，先成立一家假公司，再使它在伦敦证交所上市，然后通过假文件和谣言抬高公司股价，最后售出他们持有的公司股票。	成立	上市	1
奥巴马称剩余金融救援计划细节可能推迟公布中新网2月1日电 美国7000亿美元金融救援资金的剩余部分如何使用引人关注，据中央电视台援引美国有线新闻网1月31日的报道，由于各方对第二阶段金融救援计划细节仍存分歧，原定于在二月第一周公布的这一计划将推迟一周公布。	分歧	公布|公布	1
季莫申科首先就国内的政治经济形势问题向议会作了报告，然后接受了议员们的质询。	作了报告	接受	1
季莫申科首先就国内的政治经济形势问题向议会作了报告，然后接受了议员们的质询。	作了报告	接受	1
警方调查显示，失控军车先是撞飞了一块路牌，之后冲出道路并翻滚数次后才停下。	撞飞	停下	1
以色列明日举行议会选举 鹰派人物有望成总理中新网2月9日电 据相关《文汇报》报道，在以色列与巴勒斯坦的武装冲突阴霾笼罩下，以色列明日(10日)举行议会选举，保安议题成为主宰选情的关键，造就右翼势力重新崛起，在民调中领先的鹰派候选人内塔尼亚胡有望强势回归，再次成为总理。	回归	成为	1
尤先科继续讲话，指责季莫申科总理在签署俄乌天然气协议时超越职权，而且一再撒谎，同时否认自己与卷入天然气供应腐败丑闻的中间商俄乌能源公司有联系。	讲话	签署|超越	1
乌克兰总理随后离开会场，召开新闻通气会，指责尤先科企图撕毁俄乌天然气直接供应协议，再度启用腐败的中间商俄乌能源公司。	撕毁	启用	1
他们先向警卫开火，然后闯入大楼，其中数人边射击，边逐层上楼。	开火	闯入	1
“我先是听到枪声，”附近居民阿迦说，“接着看到一名20岁左右的男子藏在一辆车后。	听到	藏在	1
 据报道，尽管从胡佛总统的夫人开始，美国第一夫人常在时尚类杂志上露面，但能够登上《时尚》杂志封面的，米歇尔是第二人。	露面	登上	1
《华尔街日报》进行的最新美国经济前景预测调查结果显示，经济学家们预测今年第一季度美国经济按年率计算将下降4．6％，第二季度将下降1．5％，而在去年9月份，他们预测今年第一季度美国经济按年率计算将增长1．2％，第二季度将增长1．9％。	增长	增长	1
从卡特开始，历任美国总统履新时，一般都会先就贸易、人权和台湾等问题对中国政府横加指责，然后逐步过渡到友好合作的正常状态。	指责	过渡	1
她说，根据联邦法律，州参议院可以先判定对伯里斯参议员的任命是暂时的，然后通过一项法案进行特别选举，遴选出永久参议员。	判定	通过一项法案进行|进行	1
她说，根据联邦法律，州参议院可以先判定对伯里斯参议员的任命是暂时的，然后通过一项法案进行特别选举，遴选出永久参议员。	判定	通过一项法案进行|进行	1
首先，他向钢管内通入二氧化碳和水蒸气，用纳米管薄膜覆盖住仪器的后部，然后在容器顶部安装石英窗户使阳光进入。	通入|覆盖	安装|进入	1
在全球经济不景气的情况下，这是一个向外界展示全球排名第一第二的经济大国携手合作的良机。	展示	携手|合作	1
按行程，奥巴马的专机将会在十九日上午十点半降落在渥太华国际机场十一号跑道，他会先在那里与加拿大总督庄美楷进行简短的私人会谈，然后驱车前往国会山，与哈珀进行十分钟“一对一”会谈，此后进行高级官员会谈及工作午餐。	进行	前往	1
比较常见的冒领方法是，议员第一天晚上10点以前到达斯特拉斯堡会议现场签到，参加完第二天的会议，第三天一早签到后便离开。	到达	参加	1
伊朗当局封锁支持改革派前总统的竞选网站人民网北京2月23日讯 伊朗当局封锁了两个支持改革派前总统卡塔米再次竞选总统的网站，这是伊朗强硬派设法阻止卡塔米在今年6月12日大选中挑战现任总统艾哈迈迪内贾德的第一个迹象。	封锁|竞选	挑战	1
塔利班称：“我们听说，政府宣布一项永久停火协议，”塔利班指挥官法兹鲁拉通过一家非法电台说，“但是我们先前宣布了一项10天停火协议，我们打算等这项协议到期后再考虑是否延长停火期。”	宣布	考虑|延长	1
飞行员应该是希望爬高后再次降落，因此抬升机头，不过飞机速度已经慢了下来，机尾最先碰到了地面并脱落，整个机身也猛地掉下来，断成两截。	降落	抬升|慢了下来，机尾最碰到了地面并脱落|碰到了地面并脱落|脱落|断成	1
当满月的光线照射到这一冷一热空气层之间的边界，光线的路径就会发生改变，于是产生了出现第二个月亮的幻景，而且第二个月亮紧紧依附于第一个月亮。	出现	依附	1
物理学家利斯·考利博士说，第二个“月亮”是第一个月亮的镜像，当第一个徐徐升起时，第二个反而会落下。	升起	落下	1
在30分钟的演讲中，奥巴马首先称美国政府将通过把安全责任完全移交给伊拉克政府来负责任地结束伊拉克战争，并已经为此制订了未来18个月内撤出战斗部队的时间表，“说得再简单点，在2010年8月31日之前，我们在伊拉克的战斗任务将结束……	移交|结束	撤出	1
劫匪首先对银行职员实施殴打，然后驾车将他和女友、女友母亲以及一名5岁女孩带走。	殴打	带走	1
劫匪首先对沙恩·特拉弗斯实施殴打，然后驾车将他和女友、女友母亲以及一名5岁女孩带走。	殴打	带走	1
三十三人生还 七十二失踪 上任还不到两个月的孟加拉国女总理哈希娜处理此事软硬兼施，先是接见兵变代表招降、保证给予特赦并承诺会检讨叛军各项诉求，安抚不成后接着就动员装甲等部队包围封锁强势镇压终于弭平这场兵变。	接见|检讨	动员|弭平	1
罗森菲尔德说这些妇女先是被带到埃及的西奈半岛，然后经由埃及和以色列边境的沙漠地带走私进入以色列境内。	带	进入	1
他先是敲响了亲戚马克叔叔的大门，结果没人开门；接着他又骑车去拜访妈妈的朋友米歇尔，结果米歇尔接到科尔失踪的电话赶去安慰妈妈海莉了；然后科尔往回走经过家门赶去看看正在上班的爸爸，在路上学校同学的奶奶曾试图拦住他，结果他加速冲了过去，可惜爸爸也已经到处找他去了。	敲响	开门|拜访	1
去年排名第一的巴菲特(Warren Buffett)今年落居第二，身价估计在370亿美元，而去年排名第二的墨西哥电信巨子史林家族(Carlos Slim Helu & family )则是以350亿美元身价排名第三。	落居	排名	1
不过，欧盟认为，应首先评估已经实施的经济刺激计划的效果，然后再决定是否实施新的经济刺激计划。	评估|实施	实施	1
朝鲜向国际海事组织通报称，第一个发动机将坠落在距离咸镜北道花台郡舞水端里试验场650多公里的地方，第二个发动机将坠落在3600多公里的地方。	坠落	坠落	1
首先第一条是坚持无核化，第二条就是坚持在这个问题上美国和日本、韩国保持协调。	坚持	保持	1
据来自苏丹的消息，为对抗海牙国际刑事法院对苏丹总统巴希尔发出的逮捕令，苏丹政府决定展开广泛的外交活动，其中由苏丹副总统塔哈将率领的第一个代表团将要前往3个非洲国家——乌干达、利比亚和布基纳法索，向被访问国领导人阐述国际刑事法院决定的背后阴谋以及苏丹为和平解决达尔富尔问题要采取的具体措施；由总统助理纳菲阿率领的第二个代表团准备前往欧洲的英国和法国，成员有巴希尔的顾问穆斯塔法、国家安全和情报局长库什；以财政部长贾兹为首的第三个代表团要访问中国、日本、俄罗斯和土耳其；第四个代表团由总统顾问苏莱曼带队，将访问墨西哥、委内瑞拉和巴西；由总统顾问布纳和外交国务部长萨马尼率领的第五个代表团将要访问奥地利、克罗地亚和捷克。	率领|前往	前往	1
1994-1996年，俄罗斯联邦政府发动第一次车臣战争，1999年俄罗斯又进行了第二次车臣战争，基本平定了车臣叛军，但车臣境内仍有非法武装活动。	发动	进行	1
如果这名第一候选人没有获得必需的支持票数，理事会将再对另一名候选人进行投票。	获得	投票	1
但普京在卸任总统前夕签署一项法令，规定地方行政长官的年度述职报告要先提交政府，由总理作出考评结果，然后呈报总统。	提交	作出|呈报	1
据专家估计，朝鲜的第一级助推火箭预计将落于日本海，第二级将落入太平洋，但一旦发射失败或出现故障，火箭的某一级或部分残片就有可能落入日本，这就需要日本在瞬间必须作出击毁的决定，然而“机会”却稍纵即逝。	落于	落入	1
 奥巴马拒绝了捷方让他一下飞机就去总统府的密集官方活动安排，他4日在结束德法边境的北约60周年庆典飞到布拉格之后的当天晚上没有任何公开活动，他也不想要捷克官员陪同，据称他当晚只与陪伴他欧洲之旅的第一夫人米歇尔在一起享受布拉格。	结束|飞到布拉格之后的当天晚上没有|没有	陪同，据称他当晚只与陪伴他欧洲之旅的夫人米歇尔在一起享受|享受	1
美第一夫人手揽英国女王被指违反皇室礼节(图)中新网4月3日电 美国第一夫人米歇尔这次随丈夫奥巴马赴G20峰会，再次凭衣着品味在英伦掀起旋风。	手揽	掀起	1
为拉动车市，普京政府早在1月就密集出台了一系列拯救车市的措施，主要手段是对本土汽车品牌的保护：首先提出了20亿卢布低息贷款的救助资金，总共60亿卢布，分3年完成；第二是125亿卢布的政府采购计划；第三是将居民购置价格在35万卢布以下汽车的车贷利率降低三分之一；第四是拨款100亿卢布成立交通部汽车租赁专项基金等。	提出	完成	1
法第一夫人布吕尼迎接奥巴马改亲脸为握手(图)中新网4月5日电 美国总统奥巴马与夫人米歇尔到访法国时再施展魅力，连一向热情奔放的法国第一夫人布吕尼(Carla Bruni)也似乎被他的魅力慑住，突然变得害羞起来。	迎接|到访	施展	1
据韩国联合通讯社报道，李相熹当天在韩国国会国防委员会会议上说，据韩方判断，朝鲜当天上午所发射火箭的第一节、第二节和第三节全部坠海。	发射	坠海	1
日本媒体提供的后续情况最为详细：朝鲜火箭发射升空后，第一级箭体于11时37分坠落于秋田县西方东海海域，第二级箭体于11时43分坠落在距日本以东1270公里的太平洋海域，而火箭的搭载物随即被推入地球轨道。	坠落	坠落	1
先是用锤子将运钞人员打晕，然后旁若无人地实施抢劫行动。	打晕	实施	1
朝鲜当地时间11时20分成功发射名为“光明星2号”的试验通信卫星，当天发射的火箭第一节于当地时间上午11时37分落在日本海，第二节已于11时43分落在日本以东270公里的太平洋海域。	落在	落在	1
米歇尔陪同奥巴马抵达伦敦之后，首先前往唐宁街与英国首相布朗和夫人莎拉共进早餐。	陪同|抵达	共进	1
本月8日，一艘满载联合国救援物资的货轮（悬挂美国国旗）遭4名海盗偷袭，并一度被海盗控制，该船船长菲利普斯在海盗登船后，首先要求自己的船员集体反锁在一间屋子内，然后主动成为海盗的俘虏，目前已被海盗扣留了三天。	反锁	成为	1
据悉，他发誓要在电话亭中住满一个月时间，第一是为了引起美国总统奥巴马对他栽种“美国第一树”要求的重视，第二是为了顺带打破一项世界纪录，成为全世界在电话亭中生活时间最长的人。	栽种	打破	1
据悉，他发誓要在电话亭中住满一个月时间，第一是为了引起美国总统奥巴马对他栽种“美国第一树”要求的重视，第二是为了顺带打破一项世界纪录，成为全世界在电话亭中生活时间最长的人。	栽种	打破	1
》杂志专访时说，她在担任美国第一夫人后，就再也没有得到过任何工资报酬。	担任	得到	1
美国红十字会为此修建的第一个可以容纳300人的临时庇护所已经满员，该组织不得不再建庇护所以安置其他受困人员。	修建	安置	1
她们首先接受了一系列侦查技术的课程培训，然后正式上岗。	接受	上岗	1
罗戈津说：“第一个原因：俄罗斯和北约尚未恢复军事接触，双方也还没有恢复信任，此时在我国边界附近舞刀弄枪显然是挑衅性的；第二，格鲁吉亚政治领导层至今尚未对自己侵略邻国的计划做出深思熟虑的思考，此时在格鲁吉亚境内无论举行任何军事把戏都只会是搅混水式挑衅；另外，格鲁吉亚反对派现在正集会示威要求萨卡什维利总统下台，国内政治对抗局面随时可能失控，此时北约在此举行演习显然是愚蠢的、极不明智的。”	恢复	恢复	1
卿成为加州首位女性亚裔议员9、2007年6月，华裔候选人朱感生成为圣荷西市第一位华裔市议员10、2006年2月11日，23岁的罗达伦在金宝市市政府宣誓就职市议员11、2005年，丁右立获任旧金山市估值官12、近日，刘璇卿顺利当选加州第21选区参议员13、2008年11月，邱信福当选旧金山华埠／北岸区市议员14、近日，蒙特利公园市前华裔市长赵谭美生顺利当选该市市议员后，随即宣布将参选联邦第32选区众议员15、今年，佛利蒙市有6位华人参选：竞选市长的曹业云、市议员候选人陈李素英、参选教委的吴苇和高叙加、角逐华盛顿医院董事的李依云和奥隆尼社区大学校董候选人沈建飞16、3月4日，喜瑞都市华裔市议员陈金凯莉连任该市市议员17、旧金山分区选举，第四区市参事朱嘉文顺利连任，马兆光和李闰平之中将有一人笃定问鼎第一区市参事，第三区市参事候选人邱信福则大幅领先[4] 特拉华州1984年11月，吴仙标当选为美国特拉华州副州长，成为美国有史以来第一位担任州长职位的华人[5] 马萨诸塞州2007年11月，在马萨诸塞州地方选举中，28岁的黄素芬当选费奇堡市市长，成为该市首位华裔市长[6] 新泽西州1、刑天佑是新泽西州桥水市的市议员，目前以无党派独立身份参选新泽西州国会第7国会众议员选区的联邦众议员席位2、今年2月，西温莎市华裔市长薛信夫宣布，将于今年5月再度竞选连任，若获当选，将是他担任西温莎市市长的第3任[7] 伊利诺伊州今年4月，梅孟勤高票当选美国橡树溪市首位华人市议员[8] 德克萨斯州1、2007年11月，陈筱玲当选德州华裔众议员2、周建源5月将竞选连任艾迪森市长[9] 阿拉巴马州2003年，谢兰当选美国蒙哥马利市市长，2006年获得连任亚利桑那州邓悦宁，美国早期仅有的8位华裔律师之一，1946年以民主党候选人资格竞选亚利桑那州议员成功，成为美国历史上第一个不在美国出生而当选为州议员的华人夏威夷州邝友良，夏威夷华侨首富。	担任	当选|宣布|竞选	1
根据备忘录，双方将围绕建立自贸区举行两轮谈判，第一轮谈判将于今年5月在安卡拉举行，第二轮同年7月在的黎波里举行，双方将于今年9月利比亚九·一革命节期间签署自贸协议。	举行	举行	1
哥伦比亚确诊南美洲第一个甲型H1N1流感病例人民网5月4日讯 据来自波哥大的消息，哥伦比亚政府昨天确认第一个甲型H1N1流感病例，这也是南美洲这种传染病确认的第一个病例和拉丁美洲继墨西哥和哥斯达黎加之后第三个发生这种传染病的国家。	确认	确认|发生	1
在诊所方面，医护人员站在最前线，都作有自我防护措施，沈之君说，就连病人在候诊时，考虑到最好的防范，常请病人先在自己车子里等候，等轮到时再进到诊所。	等候	进到	1
餐馆先是被限制缩短营业时间，到下午六点必须打烊，后来被强令不得接待顾客堂食，只能提供熟食外卖服务，再到后来，干脆被划归为“非基础性”经济活动被勒令歇业。	限制|缩短	打烊|接待|提供	1
奔波一天，回到家里，二话不说先一头扎进工作间，拆下相机上包裹的保护膜，把机器设备用酒精棉精心擦拭一遍，放进小孩子们够不着的高处，然后冲进卫生间，换下全身衣服，塞进洗衣机，自己则仔仔细细洗澡。	扎进	擦拭|放进小孩子们够不着的高处，冲进|冲进	1
这一结果将首先被送交支持性婚姻的华盛顿特区市长芬蒂的批准，然后提交国会。	送交	提交	1
博斯沃思6日从美国启程后，将先抵达中国(7日)，接着访问韩国(8日)、日本(11日)、和俄罗斯(12日)，预定于14日返回美国。	抵达	访问	1
据悉，这场“醉酒风波”发生之后，起初德国官方和当地媒体均“保持沉默”，直到6日，德国发行量最大的《图片报》才率先披露了此事。	发生	保持|披露	1
在国防部长盖茨和国家安全顾问琼斯的大力倡导下，他接受了这样一个“路线图”：首先，要求以色列冻结在约旦河西岸的定居点和东耶路撒冷的建设，之后放弃在西岸大部分已建的定居点，撤除哨所，将东耶路撒冷全部归还巴勒斯坦：最后，要求以色列承认独立的巴勒斯坦国，即使这个巴勒斯坦国由哈马斯领导。	接受	冻结|放弃	1
但奥巴马在这一问题上似乎开始“变卦”：先是宣布将通过法律途径，阻止公布国防部的数百张美军在伊拉克和阿富汗的虐囚照片；接着表示要重启特别军事法庭，恢复审判关塔那摩部分恐怖嫌犯。	宣布	公布|重启	1
议员们认为，应该首先就如何处理仍被拘禁在那里的240名在押人员制定出一个计划，然后在为关闭该中心拨款。	处理|拘禁	关闭该中心拨款	1
苏丹尼在本月14日已递交辞职申请，但总理马利基要求议会先对其指控进行检视后再接受辞职报告。	要求|检视	接受	1
当天，朝鲜方面宣布：再次“成功地进行 了地下核试验”并取得“成功”，核爆炸威力“比前一次更大”——朝鲜第一次进行核试验时，韩方监测到的震级为3.6级 。	进行|取得	进行	1
在4月9日举行的印尼国会选举中，苏西洛领导的印尼民主党胜出成为第一大党，优素福·卡拉领导的专业集团党和梅加瓦蒂领导的印尼民主斗争党分别位居第二和第三大党地位。	胜出|成为	位居	1
如果在第一轮选举中没有一组候选人获得超过半数的绝对多数票，将于9月举行第二轮投票。	获得	举行	1
猎鲸者先将船只排成半圆形，把鲸鱼围起来，再慢慢地把它们赶到海湾里。	排成	围起来，慢慢地把它们赶到|赶到	1
在秘书处大楼游客大厅内举行的悼念仪式上，联合国秘书长潘基文首先向牺牲的维和人员敬献花圈，然后带领到场的几十位联合国维和部门官员和各国代表默哀一分钟。	敬献	默哀	1
盖茨说，朝鲜先前多次将发展核技术作为谈判筹码，威胁国际社会提供援助或作出让步，然后就会撕毁它先前的承诺，美国已对这一做法感到厌烦。	发展	提供|作出|撕毁	1
盖茨说，朝鲜先前多次将发展核技术作为谈判筹码，威胁国际社会提供援助或作出让步，然后就会撕毁它先前的承诺，美国等已对这一做法感到厌烦。	发展	提供|作出|撕毁	1
“首先要做的是整顿体系，清理干净后对公众敞开，然后向好的方向转变。”	整顿	敞开	1
乌克兰宪法中关于提交宪法修正案的特别程序规定，其程序必须先后在议会两次会期内解决，首先相关法案应得到议会简单多数(226票)通过，然后提交宪法法院裁决，问题在于这个程序可能会持续很长时间，最后通过的修正案只有在下次议会全会上至少得到三分之二法定多数(300票)议员的支持才算通过。	通过	提交	1
韩国：与朝鲜紧张关系升级称会对朝随即还以惩罚记者：这个消息在韩国传出之后，原先出现升势的韩国首尔综合股指突然转向下行，路透社报道，韩国军方2号下午向朝鲜半岛的西侧，两国有争议的海域附近地区派遣了一艘附属于海军的导弹舰艇，这艘舰艇是反舰导弹舰，主要负责增援高速的海军舰队配合行动，法新社方面援引了韩国官员的话说，反舰导弹舰装备精良，装备有可以压倒对方的重型武器，有一位军官也说，如果朝鲜方面有任何的挑衅行动，韩国军队会随即还以惩罚，韩国的媒体当天援引韩国国防官员的话说，正在向朝鲜加强军备，储备军火，接连向韩国方面发出了禁防令，双方局势可以说是比较紧张的。	传出	派遣|还以|加强|储备|发出	1
俄专家认为朝鲜已备战但不会先发制人环球时报特约记者梁小逸报道 在朝鲜进行第二次核试验以及试射导弹之后，朝鲜半岛局势再次骤然紧张。	备战|发制人环球时报特约记者梁小逸报道在朝鲜进行|进行	紧张	1
但是金灿荣教授认为奥巴马重启巴以和谈的希望还是有的，不过奥巴马目前面临一些具体的困难：首先，以色列态度很强硬；其次，巴勒斯坦内部是两支不同的力量，究竟和哪一方谈判才有效，奥巴马政府面临一个技术难题；再次，阿拉伯世界的态度也至关重要，作为忍受了半个世纪屈辱的阿拉伯国家人民能否从感情上接受以色列也还是有难度的。	面临	面临	1
法新社等媒体注意到，朝方扣留两名美国女记者后，先后3次允许瑞典驻朝使馆外交人员与这两人见面，上月26日即朝鲜宣布实施第二次地下核试验次日，这两名女记者还获准与在美国的家人通电话，这些举动值得关注。	允许	宣布|实施	1
记者：这轮朝美关系的紧张是从今年4月5号开始的，当天朝鲜宣布发射了光明星二号通讯卫星，此举遭到了美国、日本、韩国等国家的强烈谴责，此后朝鲜宣布退出六方会谈，并且在5月25号再次进行了地下核实验，此后还连续进行了一系列的短程导弹试验，面对朝鲜方面的举动，美国总统奥巴马国务卿希拉里都先后发表了措词严厉的讲话，美国总统奥巴马本月6号在访问法国期间表示，美国将严格审视朝鲜宣布实施核试验之后的局势，以及采取更为严厉的措施，而不会继续奖励挑衅行为的政策，美国国务卿希拉里7号则表示，鉴于朝鲜再次进行核试验和导弹发射，美国正在考虑将朝鲜重新列入支持恐怖主义国家的名单，而美国也正在考虑单方面对朝鲜实施金融制裁，与此同时美国还在竭力推动联合国安理会对朝鲜实施新一轮的制裁。	发表	访问|审视|实施	1
当年，内贾德和前总统拉夫桑贾尼在第一轮选举中打成平手，但内贾德后来在第二轮选举中成功胜出。	打成	胜出	1
美国考虑单方面金融制裁共同社报道，最新版本草案中，安理会对朝鲜宣布实施第二次核试验表示“严重关切”，谴责这一行为“违反并公然无视”安理会先前的相关决议。	宣布|实施	无视	1
在朝鲜发布进行第二次核实验的声明后，韩国和美国官员称，他们探测到了地震波，来源位于朝鲜东北部咸镜北道丰溪里，那里距朝鲜进行第一次核实验的地点很近。	发布|进行	探测	1
一位商人这样描述他冒领救济粮的过程：“我先去联合国机构领取一份表格，然后冒用难民营的名义提交，我会把领到的救济粮送一部分去难民营，当然只是很小的一部分。	领取	提交	1
达西瓦还讲述了他核对彩票时的情形，他使用自助机器核对四张彩票，第一张彩票中了10加元，他心想还不错，继续核对第二张，显示出来中了2400万！	中了	核对	1
青瓦台和先进党之间截然不同的主张虽然有所平息，但无论如何，两位首脑就派兵阿富汗问题进行讨论的事实被公开之后，政府有关部门对此感到非常尴尬。	平息	讨论|公开	1
据路透社消息，“穆萨维已经指示支持者20日和21日不要再组织任何游行示威活动，如果决定组织活动会事先在穆萨维网站上公布。”	指示|组织	决定|公布	1
流感疫苗生产企业通常会使用鸡蛋培育疫苗，而蛋白质科学公司利用的昆虫细胞技术则是首先从甲型H1N1流感病毒中提取血凝素基因，然后将其植入对人体无害的昆虫杆状病毒，再让后者在毛虫细胞内迅速繁殖。	利用|提取	植入	1
加州的信用评级本来就在美国各州中名列倒数第一，标准普尔最近再次将加州的信用评级列入观察名单。	名列	列入	1
科学家选取50名男大学生和60名女大学生，让他们先互相交谈，再参加考试。	交谈	参加	1
美国作家大卫·海曼在即将于下月出版的新书《博比与杰奎琳:一场情事》中披露，杰奎琳在丈夫遇刺身亡成为寡妇后的第二年，不但和小叔子博比·肯尼迪暧昧不清，而且还成功勾引了素有“好莱坞坏小子”之称的奥斯卡影帝马龙·白兰度!守寡期间跟小叔去度假据海曼在书中披露，美国前“第一夫人”杰奎琳·肯尼迪虽然外表冷静高贵，内心却充满激情狂野。	遇刺身亡|成为	暧昧|勾引	1
如果在第一轮总统选举中没有人获得50%以上的选票，前两名候选人将在9月份举行的第二轮总统选举中再次进行角逐。	获得	举行|进行|角逐	1
如果在第一轮总统选举中没有人获得50%以上的选票，前两名候选人将在9月份举行的第二轮总统选举中再次进行角逐。	获得	举行|进行|角逐	1
当有导弹来袭时，先由海上自卫队的海基“标准-3”导弹在100公里以上高空的大气层外进行拦截；如果拦截未能成功，再由航空自卫队的陆基“爱国者-3”导弹在高空进行二次拦截。	进行|拦截	进行	1
依照印尼法律，如果在第一轮选举中没有一名候选人获得超过半数的绝对多数票，将于9月举行第二轮投票。	获得	举行	1
前一晚受到第一次攻击的网站中，总统府青瓦台、最大门户网站Naver、《朝鲜日报》、国防部和亿贝公司韩国站点Auction等6家网站8日晚再次受到攻击。	受到	受到	1
我先是出访俄罗斯，接着前往意大利出席八国峰会，之后我出于一个简单原因来到加纳。	出访	前往|出席	1
科雷拉说，工作人员先将核弹运送到指定的拆除地点，然后用起重机将它放置在地面。	运送	放置	1
报道表示，事后该公交车公司发言人指出，“我们将尽快对那名司机进行询问，首先要搞清情况，然后才能做出结论并作出处理。”	搞清	作出	1
但也有观察人士认为，自民党之所以没有抢先“竖起大旗”，一方面是试图先了解对手的政策主张，再制定针锋相对的纲领。	了解	制定	1
第一次要求朝鲜警备艇返回朝方水域，由韩方“处理越境的朝鲜渔船”；第二次警告“如果(朝鲜警备艇)不返航，(韩方)将进行射击。	返回	处理|返航	1
韩国教育科学技术部当天表示，火箭第一级在7月30日成功进行了点火试验，但经过仔细分析之后又发现了新的技术问题，因此韩国和俄罗斯相关技术人员还需要一些时间对此问题进行协商解决。	进行	发现	1
不过，《朝鲜日报》也指出有人持反对意见，认为在朝鲜进行第二次核试验、发射远程导弹并被怀疑扩散核等情况下，把“不扩散”视为最优先价值的奥巴马政府不会轻易改善同朝鲜的关系。	进行|发射	改善	1
一手造凶案一手做直播然而近日，巴西警方却揭露惊人真相：华莱士为了追求独家报道和高收视率，涉嫌“策划”9宗谋杀案，至少有9人遇害，然后据此制作出“第一手”的节目。	遇害	制作	1
他还就不再要求立即展开谈判的上述三点表示，“不会一下子到谈判桌上要求改变，而是先增进信任”。	展开	要求|增进	1
本次会议分成两部分：首先是13－14日举行的东盟经济部长会议，参加者是东盟10个成员国的经济部长及经济高官；然后是15－16日举行的东盟与6个对话伙伴国的经济部长会议，这6个对话伙伴国分别是中国、日本、韩国、澳大利亚、新西兰与印度。	举行	举行	1
埃及总统称中东和平系承认以色列先决条件中国日报网环球在线消息：据英国媒体报道，正在美国访问的埃及总统穆巴拉克8月17日接受埃及《金字塔报》(al-Ahram)采访时表示，唯有中东地区实现全面和平之后，阿拉伯国家才会承认以色列并与其实现关系正常化。	承认	接受|实现	1
而他一生中坐牢的时间也颇为不少，加入政坛之后，先后三次企图问鼎总统宝座而不果，以古稀之年行第四次努力而成功，并在2000年因促成朝韩两国首脑的首次会谈而获得当年度诺贝尔和平奖。	加入	问鼎|促成|获得	1
演习为期近两个月，将分3个阶段进行：第一阶段是在位于莫斯科的集安组织联合司令部举行首长司令部演习；第二阶段于9月中旬在白俄罗斯举行，将有来自俄罗斯、白俄罗斯、亚美尼亚和哈萨克斯坦的军事人员参加；快速反应部队直接参与的第三阶段演习则于10月份在哈萨克斯坦境内的马特布拉克训练场举行，届时将邀请集安组织成员国元首参加。	举行	举行	1
    两次朝韩峰会    2000年6月    第一次朝韩峰会 金大中访问朝鲜    2007年10月   第二次朝韩峰会 卢武铉访问朝鲜	访问	访问	1
然后，他利用谷歌设计了逃跑路线，他先住进了一家海景酒店，穿上潜水设备，再穿上黑色“布尔卡”(当地妇女所穿的一种蒙住全身、只留眼睛的连身长袍)把自己伪装成一个女人。	住进	伪装	1
根据警方指控，他们首先抢劫当地的华人超市，然后再向超市老板敲诈勒索，收取“保护费”。	抢劫	敲诈	1
这将是双方红十字会时隔两年之后首次举行会谈，也将是双方离散家属继2007年10月之后的第一次会面。	举行	会面	1
“我非常自豪，我们是第一支访问中国的NBA球队，”奇才队总裁波林说，“我们认为再次访问中国是对1979年的那次历史性访问的最好纪念。”	访问	访问	1
欧盟从本月起逐步淘汰白炽灯新华网布鲁塞尔8月31日电 (记者 刘秀荣) 欧盟委员会8月31日说，欧盟淘汰白炽灯第一阶段禁令9月1日起正式生效，欧盟各国商家将不能再购进100瓦白炽灯，但可以继续把存货卖完。	淘汰|生效	购进	1
根据罗选举法有关规定，如果总统选举第一轮投票中候选人无一获得过半选票，得票最多的两名候选人将在14天内举行的第二轮投票中决一胜负。	获得	举行|决一	1
“这次行程的第一个目标是反击篡改二战历史的企图，”俄政府办公厅副主任乌沙科夫在普京启程前召开的媒体吹风会上说，“第二，是要为俄波双边关系注入活力。”	反击	启程	1
费德罗夫的话说，“两年前，俄罗斯与叙利亚签订了两份合同，第一份合同是俄罗斯向叙利亚出售米格—29M战机，第二份合同是俄罗斯向叙出售米格—31E。	出售	出售	1
第一份合同目前正在执行过程中，第二份合同现在还没有执行，双方还就一些细节问题进行协商，我希望合同能很快执行。”	执行	执行	1
此前，众议院能源和商务委员会、筹款委员会、教育和劳动力委员会以及参议院卫生、教育、劳工和退休金委员先后通过了有关提案，但参议院财金委员会至今未能就医改计划达成一致，他们将于四日进行再次磋商。	通过	进行	1
在谈到朝鲜这一举动对朝鲜半岛有何影响时，朱峰表示，近期朝韩之间动作频繁，先是韩朝红十字会代表团签署协议定于9月26日至10月1日在金刚山举行离散家属会面活动；接下来又是9月1日朝韩陆路边界通行恢复正常。	签署|举行	恢复	1
信函归咎国际社会把朝鲜“和平发射人造卫星当成问题”，促使他们进行第二次核试，又表示朝鲜已准备好对话或对抗制裁，“假如安理会某些常任理事国想先制裁后对话，我们将在与他们当面对话前，提升核威慑以应对”。	进行	提升|应对	1
技术解读浓缩铀更易造核武用钚制造的核武器更易小型化据新华社电 美联社认为，实施铀浓缩能够帮助朝鲜获得第二种制造核武器的方式，有专家先前已怀疑朝鲜在开展这一工程。	实施|获得	开展	1
近年来，空客公司更是加大了研发力度，继成功推出空客A380之后，正在积极筹划生产性能更为先进的空客A350。	推出	筹划	1
千海成在当天的例行新闻发布会上说，韩国政府7日上午以国土海洋部长官的名义向朝方发出通知书，对朝方在没有预先通报的情况下开闸放水并造成6名韩国人失踪表示遗憾，要求朝方解释原因，并强烈敦促朝方在开闸放水问题上与韩方加强合作，防止类似事件再次发生。	开闸放水并造成|造成	解释	1
韩国统一部发言人千海成7日说，韩国政府当天上午以国土海洋部长官的名义，通过韩朝热线向朝方发出通知书，对朝方在没有预先通报的情况下开闸放水并造成6名韩国人失踪表示遗憾，要求朝方解释原因，并强烈敦促朝方在开闸放水问题上与韩方加强合作，防止类似事件再次发生。	开闸放水并造成|造成	解释	1
为早日捉拿嫌犯，施瓦辛格率先于4日下令悬赏10万美元，接着洛杉矶郡政委员安托诺维契(Michael Antonovich)追加5万美元的提案也在8日无异议通过。	下令|悬赏	通过	1
摩尔多瓦是议会共和制国家，大选后产生的新议会首先以简单多数票选出议长，然后再选举总统，总统候选人必须获得议会101名议员中至少61人支持才能当选。	产生|选出	选举	1
但是就在近日，阿联酋政府获得情报，称恐怖分子正在计划袭击这座世界第一高楼，欲制造第二桩“911”。	计划袭击|袭击	制造	1
在奥巴马发表声明之后，美国国防部长盖茨对记者表示，应用新技术的防导系统将比原先的版本更符合当前的要求，就当前而言，伊朗的长距离导弹未构成什么威胁。	发表	构成	1
在车站附近山庄工作的男职员(59岁)称，这只熊先是在附近山中袭击游客，向车站奔跑途中再次咬伤其它游客。	袭击	奔跑|咬伤	1
奥巴马：需先确定对阿富汗战略后再考虑增兵中新网9月21日电 奥巴马在周日接受采访时表示，他希望等美国驻阿富汗军事战略确定后再考虑是否增兵。	确定|考虑	确定|考虑|增兵	1
列维的前夫拉斐尔也已经再婚并有了一个孩子，而他仍经常与身为第一夫人的布吕尼联系，几乎每天都要与之通电话，并时常应邀前往爱丽舍宫和总统共进晚餐。	再婚	联系|前往	1
俄前总理称普京曾派人监视叶利钦“普京担任俄罗斯总统之后，他的前任——俄联邦第一位民选总统叶利钦成了克里姆林宫的囚徒，他的每一次电话都被监听，行动和对外联络都受到限制。	监视|担任	成了克里姆林宫的囚徒，他的每一次电话都被监听|监听|受到限制|限制	1
在演讲中，他抛出了很多惊人言论，先是说“新型流感是某个国家为了军事目的施放的细菌武器”，然后念起了《联合国宪章》，激烈批判安理会不民主以及无能。	施放	念起	1
他先是斥责美国前总统布什和英国前首相布莱尔为“大屠杀制造者”，接着称“甲型H1N1流感是某个国家为了军事目的而释放的细菌武器”，并要求彻查遇刺美国前总统约翰-肯尼迪和民权运动先驱马丁-路德-金的死因，他甚至还替塔利班“维权”，称应该维护塔利班建立“伊斯兰酋长国”的权利。	斥责	释放	1
他先是斥责美国前总统布什和英国前首相布莱尔为“大屠杀制造者”，接着称“甲型H1N1流感是某个国家为了军事目的而释放的细菌武器”，并要求彻查遇刺美国前总统约翰-肯尼迪和民权运动先驱马丁-路德金的死因，他甚至还替塔利班“维权”，称应该维护塔利班建立“伊斯兰酋长国”的权利。	斥责	释放	1
社论认为，去年11月在华盛顿举行第一次峰会时，韩国提出“为防止贸易保护主义出现，今后一年里不要再增设贸易、投资壁垒”的“维持现状(stand still)”提议，并且在《联合宣言》中体现出来，积极发挥了发达国家同新兴国家之间的桥梁作用。	举行	提出|增设	1
若三位候选人无人在第一回合投票赢得过半数票，将进行第二回合投票，由国会议员对最高两位得票者再次投票来分出胜负。	赢得	进行	1
目前暂居第二的河野希望能在第一回合投票迫使谷垣无法赢得过半数获胜，然后在第二回合决定胜负的投票中，吸收西村的支持票俾能和谷垣一决雌雄。	迫使|赢得	决定	1
公报要求巴西立即采取措施确保塞拉亚先生不再利用巴西外交代表团提供的保护，以挑起洪都拉斯的暴力。	采取	提供	1
Seah对路透表示，这是该飞机自今年早些时候开始巴黎—新加坡这条航线之后，第一次出现这类问题。	开始	出现	1
按照规定，在第一轮投票中如果无人获得过半数选票，得票靠前的两名候选人将进行第二轮较量。	获得	进行	1
这是两人搬进白宫之后，第一次庆祝结婚纪念日。	搬进	庆祝	1
先是贝卢斯科尼的政府定义这些记者是“罪犯、无赖”，之后他又通过电视镜头警告意大利人不该看报纸，而应该相信电视(因为贝氏家族掌控着3家著名私人电视台)，他还要求很多公司不要在报刊上刊登广告。	定义	警告	1
在冲过第一道安检站后，武装分子跳下汽车，一边射击一边冲向第二道安检站。	冲过	跳下|射击|冲向	1
之后他又再次提出了建立东亚共同体的构想，并且解释说：“我想(东亚共同体)的关键在于中日韩三国首先从强化经济合作开始。”	提出	强化	1
当晚签署的和平协议包括两个协议，根据第一个协议两国将正式建立外交关系，实现关系正常化，并在协议经本国议会批准生效后两个月内开放共同边境；根据第二个协议两国将成立由历史学家组成的国际委员会，共同研究第一次世界大战前后发生的所谓“亚美尼亚大屠杀”事件。	建立	批准|开放|成立	1
布朗称，其宣布增兵需要三个先决条件，一是这些士兵拥有足够的装备并经过足够的训练；二是隼式直升机不久之后将派往阿富汗；三是装甲车和其他特殊装备将派往那里，以应对路边炸弹袭击。	宣布	拥有|派往	1
联盟成员国的总统们将在首脑会议上批准这种国际支付手段，然后进入一个很短的调整的进程，从明年起将实行第一批用苏克雷进行交易。	进入	实行	1
他在接受采访时表示：“我希望选举调查委员会本周能够公布重新计票的结果，卡尔扎伊的得票率很有可能会跌到50%以下，那么第二轮投票就有可能在11月份的第一周举行。”	跌到	举行	1
斯洛伐克与捷克在第一次世界大战结束奥匈帝国瓦解之后一起组成捷克斯洛伐克，二战前后都属于同一个国家。	结束|瓦解	组成	1
据台湾中广新闻网报道，一名受害者说，这些持枪的组织成员们会围攻戴胸罩的女性，先鞭打她们，然后再要她们脱去胸罩，摇晃胸脯。	鞭打	脱去	1
此外，不管第一次发射结果被判断为成功与否，第二次火箭发射还将按计划在明年5月执行，暂时没有改变。	判断	执行	1
根据阿富汗相关法律，如果总统选举的重新计票结果确定任何候选人都未能赢得超过半数的选票，阿富汗将在重新计票结果公布后的两周之内举行第二轮总统选举投票，由在首轮投票中得票率领先的卡尔扎伊与阿卜杜拉角逐下届总统。	公布后的两周之内举行|举行	角逐	1
据悉，奥巴马的新反导计划首先是部署海基拦截设备，第二阶段为部署针对短程与中程导弹的路基体系。	部署	部署	1
首先，各彩票销售机构只负责本门店销售；销售资金汇拢后，公益资金须上交政府部门，政府再委托专门慈善机构来具体负责；而摇奖、中奖以及计算机系统的运营由专业技术公司独立承担；最后，所有的资金流向由独立的彩票监管委员会监管，监督内容包括彩民的各项权益是否得到保障、彩票的各项收入支出报表，并及时对外公示。	负责|汇拢|上交	负责	1
他猜测身为医生的迪特尔先用特殊的药物将女儿迷倒，然后将其强奸并杀害。	迷倒	强奸|杀害	1
香港《文汇报》报道称，4.2万名英国邮件中心工作人员及司机22日率先进行24小时罢工，7.8万名邮递员会紧接着将于23日进行另一个24小时罢工。	进行	进行	1
他们先朝我们开火，然后又炮击巴卡拉市场，接着告诉人们非盟维和部队在杀害平民。	开火	炮击	1
对此，FBI方面辩称，由于文件数量迅速增多，情报分析人员已经不再依靠手工逐个打开文件，而是更多地采用先进的计算机数据库检索方式进行处理。	打开	采用|进行处理|处理	1
国际原子能机构总干事穆罕默德·巴拉迪先前提议，伊朗年底前将所持1500公斤低浓度铀中的75%运往俄罗斯提纯，然后再由法国进一步加工，最后运回伊朗用作研究用核反应堆燃料。	提议	运往|提纯，再由法国进一步加工|加工	1
但是阿卜杜拉11月1日宣布，选举委员会在第一轮投票中存在欺骗行为，他提出了确保第二轮投票公正的要求，但遭到拒绝，因此他“不会参加11月7日的选举”。	存在	提出	1
但是阿卜杜拉11月1日宣布，选举委员会在第一轮投票中存在欺骗行为，他提出了确保第二轮投票公正的要求，但遭到拒绝，因此他“不会参加11月7日的选举”。	存在	提出	1
该报援引巴军方人士的话报道，安全部队进展顺利的原因主要有以下几点：首先是军方放弃正面进攻，转走山路，占领塔利班据点周围的高地，然后向下攻击这些据点，让塔利班难以防备；二是约3万名巴士兵对阵1万多名塔利班武装分子，安全部队兵力占优势；三是巴基斯坦空军的配合方便了地面部队进攻；四是该地区其他武装组织保持中立，没有参与抵抗政府军。	放弃	占领|攻击	1
根据这份协议，马达加斯加将成立由3个人组成的总统委员会，现过渡最高权力机构领导人拉乔利纳将担任总统，前总统拉瓦卢马纳纳的高级助手安德利亚尼利纳将出任第一联合总统，前总统扎菲的支持者拉库图瓦希尼将出任第二联合总统。	出任	出任	1
此外，“冲之鸟”还处于亚太地区第一岛链和第二岛链之间，如果日本把这几块礁石打造成人工岛，建立港口甚至起降飞机，那么它就可以成为连接第一岛链和第二岛链重要跳板。	处于	打造|建立|起降	1
他要求议会首先恢复自己的总统职务，然后由他本人负责政府组建工作。	恢复	负责	1
布鲁戈告诉警方，行窃前，李先提出潜在的名人目标，然后自己会上网搜寻有关此人的信息，比如住所或出行规律等信息。	提出	搜寻	1
朝鲜要求首先与美国开展双边对话，然后才考虑是否重返六方会谈。	要求|开展	重返	1
目前从俄罗斯和美国驻日内瓦代表团得到的消息中，我们了解到两国代表团的官员和专家被分成四个小组，就条约涉及的不同领域同时展开谈判，另外呢，本轮谈判是采取轮流坐庄的方式，在美国和俄罗斯驻日内瓦代表团轮流举行，也就是说如果第一天谈判在俄罗斯使馆举行，第二天大队人马就要移师美国使馆，第三天再返回到俄罗斯使馆，俄美双方似乎是在用这种方式来显示谈判双方的对等原则。	举行	移师	1
非洲遭受第二波金融危机重创新华网亚的斯亚贝巴11月12日电(记者 熊思浩)联合国非洲经济委员会执行秘书詹纳12日说，非洲受第一波金融危机的影响较小，但随着第二波金融危机袭来，非洲出口收入下降，国际资本流入非洲减少，非洲经济遭受重创。	受波金融危机的影响较小	袭来	1
报道说，伊朗要求先取得核反应堆所需的燃料棒，然后才将浓缩铀运往俄罗斯和法国，而国际原子能机构对此无法接受。	要求取得|取得	运往	1
2006年，日本又耗资755万美元进行珊瑚养殖，先把冲鸟礁北方的珊瑚带回冲绳养殖，来年再放归冲鸟礁附近。	带回冲绳养殖|养殖	放归	1
布朗称英国誓将阿富汗战争进行到底国际在线专稿：据《纽约时报》17日报道，尽管英国的民意调查显示人们对阿富汗战争的反对日益激烈，英国首相布朗和外交部长戴维·米利班却在最近两天内先后发表演讲，表示了英国将继续与美国并肩作战并在阿富汗战争中保持兵力第二大国地位的决心。	发表	保持	1
研究人员表示，在第一束质子束流顺时针贯穿对撞机之后，第二束质子束流将注入对撞机逆时针运行。	贯穿	注入	1
巴西里约热内卢多个海滨地区再次断电中国日报网环球在线消息：据美国媒体报道，当地时间11月24日下午，巴西第一大城市里约热内卢多个地区断电数小时，这已是2周以来该市发生的第二次停电。	断电	发生	1
该节目于上周日播出第一部分，第二部分定于本周日播出。	播出	播出	1
萨莉决定先在明年5月参加伦敦威斯敏斯特区的市议员竞选，先当上一名市议员，然后她才会参加将来的议会选举，争取成为一名下院议员。	当上	参加	1
该组织发言人萨利赫-默罕默德在录音带中说：“两支勇敢的圣战者队伍成功地在两次行动中绑架了四名欧洲人：第一次行动是11月25日在马里绑架了法国人皮埃尔-加马特；第二次行动是11月29日在毛里塔尼亚抓获了三名西班牙人。”	绑架	抓获	1
第一声爆炸在当地时间上午10时25分传出，几秒后传出第二声爆炸，接着一分钟后又传出第三声爆炸。	传出	传出	1
第一声爆炸在当地时间上午10时25分传出，几秒后传出第二声爆炸，接着一分钟后又传出第三声爆炸。	传出	传出	1
据了解，博思沃斯在抵韩后将会先向美国政府汇报会谈结果，通知六方会谈其它与会国，然后再举行记者会，所以记者会的时间大约会在首尔时间下午6点左右。	抵韩后将会向美国政府汇报|汇报	通知|举行	1
杰奥夫接受再教育后，在一家会计公司获得了一份工作，没过多久，他就和伊莱恩结了婚，两人还存钱买了第一所房子。	接受	获得	1
草案内容★全球温室气体排放“可能很快”就将达到峰值★在2050年时将气温上升幅度阙值控制在1.5至2摄氏度★支持保留《京都议定书》成果，展望第一承诺期后进入为期7年的第二承诺期★为全球2050年与1990年相比的总减排量比例设定3个选项，分别是50%、80%和90%★支持自2010年起进入为期3年的“快速启动”援助方案，协助发展中国家面对气候变化问题留足“余地”恐成争论种子草案在某些关键议题上模糊处理，可以说是留出谈判空间，也可以说是埋下了争论的种子。	进入	设定	1
从科学家在水下安设的摄像机可以看到，章鱼首先从海底“收集”了两个对半分开的椰子壳并将里面的东西清空，然后将它们拖拽了长达20米的距离，最后将这两个半壳合在一起做成了一个可以藏身的“家”。	收集	拖拽	1
人们已经知道，章鱼经常从外部物体那里寻求庇护，但录像中的章鱼的进步之处在于，它事先准备了椰子壳，然后进行远距离运输，再把它们重新组合起来。	准备	进行	1
欧洲之星列车停运3天之后恢复运行中新网12月22日电 据法新社报道，自“欧洲之星”公司宣布该种列车连续停运3天之后，第一辆“欧洲之星”列车于当地时间22日上午8点10分左右从法国首都巴黎顺利发车，前往英国首都伦敦。	宣布|停运	发车|前往	1
伯塞斯库总统第一次总理提名遭到议会否决，而第二次提名又因总统选举遭搁浅。	否决	搁浅	1
伯塞斯库随后的第一次总理提名遭到议会否决，而第二次提名又因总统选举遭搁浅。	否决	搁浅	1
澳大利亚交通安全局指出，空客A330上面的机组人员首先发现这一情况，然后将这一情况报告给空中交通管制员，在管制员的协调下，航班回到正确的航线上。	发现	报告	1
博物馆工程负责人亚普曼在当天举行的工程发布会上介绍说，根据计划，工程人员将于水下首先安放3艘战舰和1架战机，之后还将在博物馆内放入各种机体船体残骸，并建造储藏室和展览室，同时配备水下急救部队。	安放	放入	1
这一连串的失误让美国总统贝拉克·奥巴马无法再保持一贯的冷静，他29日痛批美国安保系统，说美国安保系统在事先得到情报的情况下没能阻止事件发生，“让人无法接受”。	保持	痛批|阻止	1
手术在子宫内进行手术当天，医生先为母亲米歇尔实施了全身麻醉，然后切开她的子宫，仅仅将亚瑟的头部、颈部和肩膀拉出子宫，这样做是为了让亚瑟继续使用胎盘获得氧气，为接下去的手术做准备。	实施	切开	1
捷克元旦230名犯人因新法生效重获自由中新网布拉格1月2日电 据捷克媒体报道，230名在押捷克囚犯元旦因新的刑法生效而重获自由，因为新的法律文本不再把原先导致他们入狱的行为列为罪行。	重获	列为	1
丹麦漫画家险遇刺 5年前被指亵渎伊斯兰教先知中新网1月3日电 丹麦漫画家韦斯特加德多年前的一幅讽刺漫画，被指亵渎伊斯兰教先知穆罕默德之后，就不断接到死亡威胁，星期五深夜，一名持斧头和刀子的索马里男子潜入他的住家意图行刺，但及时被驻守在那里的警卫发现，开枪将他打伤。	遇刺5年前被指亵渎|亵渎	亵渎	1
沙特拟建1千米高王国塔超迪拜中新网1月5日电 全球第一高的迪拜哈里发塔4日揭幕，不过沙特阿拉伯已规划要兴建楼高1千米的王国塔，比哈里发塔高172米，王国塔是否能再创人类建筑史纪录，引人瞩目。	拟建|超迪拜中新网1月5日电全球高的迪拜哈里发塔4日揭幕|揭幕	规划|兴建	1
美方12日晨发表声明拒绝了朝鲜的提议，称朝鲜必须先履行弃核承诺，然后才能开始谈判和平协定问题。	履行	开始	1
美国称朝鲜应先重启六方会谈再签和平协定朝鲜外务省11日提出希望在今年年内对话，讨论签署和平协定、结束与美国敌对状态、终止对朝制裁等事宜。	重启	提出	1
韩国证实两家奶牛场发生口蹄疫疫情国际在线报道(记者 张玲)：韩国农林水产食品部16日证实，韩国京畿道抱川市两家奶牛场再次发生口蹄疫疫情，此前该市本月已经先后暴发过两次口蹄疫疫情。	发生	暴发	1
联邦调查局发言人肯-霍夫曼说，当初在绘制拉登最新照片时，联邦调查局的专家们对于软件生成的拉登头发感到不满意，然后就使用了拉马扎惹斯先生的照片来作为替代。	生成	使用|替代	1
乌克兰拟于下月7号进行第二轮总统投票选举中新网1月18日电 据香港“星岛日报网”报道，1月17日，乌克兰结束该国总统大选第一轮投票，但无一候选人取得过半数支持。	进行	结束|取得	1
这位发言人说，六方会谈要想再次重开，必须首先消除当初会谈被中断的原因。	重开	中断	1
但美国政府当天拒绝了朝鲜方面关于在六方会谈框架内与《朝鲜停战协定》当事国举行会谈、讨论签署和平协定的提议，称朝鲜必须先履行弃核承诺，然后才能开始谈判和平协定问题。	履行	开始	1
他先要了解到所有的事实，然后再从各个角度寻找线索。	了解	寻找	1
乌兹别克斯坦议会立法院主席获连任新华网塔什干1月22日电(记者 董龙江)乌兹别克斯坦新一届议会立法院(下院)22日举行第一次大会，塔什穆哈梅多娃再次当选乌兹别克斯坦议会立法院主席。	举行	当选	1
自由民主党议员茂木敏充批评说，鸠山内阁先是停止2009财政年度第一份补充预算部分项目，随后把这部分项目列入第二份补充预算案，前后只在数字上略作调整，这种做法“朝三暮四”。	停止	列入	1
联合国寻求将塔利班部分头目撤出恐怖名单环球时报特约记者宋华报道：据美国《纽约时报》1月24日报道，联合国秘书长阿富汗事务特别代表、联合国阿富汗援助团负责人凯-艾德要求阿富汗政府努力将部分塔利班高级领导人从联合国制定的恐怖分子名单中去除，以为接下来与恐怖组织展开直接谈判迈出第一步。	去除	展开	1
(市长选举)不是终点，现在刚跨过了第一道栏，接下来必须认真应对普天间机场问题。”	跨过	应对	1
去年3月，日本政府向索马里海域派遣了第一批自卫队舰队，7月派遣了第二批舰队，10月派遣了第三批舰队。	派遣	派遣	1
目击者称，枪手驾驶多辆汽车停在学生聚会地点外，先朝一些聚在室外的人开枪，然后还追赶一些试图逃脱的年轻人。	开枪	追赶	1
据此间媒体援引韩国政府人士的话报道，自去年下半年朝鲜对韩国发动“和平攻势”以来，韩朝间已先后4次就举行首脑会晤进行“水下接触”，朝方“同意将核问题列入会晤议题”，而韩方也“不再坚持朝鲜领导人金正日回访首尔”。	举行|进行	同意|回访	1
在最高法院作出上述判定前，斯国内部分法律专家认为，拉贾帕克萨总统的第二个任期应该从今年11月19日开始，而另一部分专家认为应该从其第一个6年任期结束后的2011年11月19日开始。	开始	开始	1
据此间媒体援引韩国政府人士的话报道，自去年下半年朝鲜对韩国发动“和平攻势”以来，韩朝间已先后4次就举行首脑会晤进行私下接触，朝方“同意将核问题列入会晤议题”，而韩方也“不再坚持朝鲜领导人金正日回访首尔”。	举行|进行	同意|回访	1
美国国际集团顶风再发1亿美元奖金据新华社电 美国国际集团(AIG)定于3日向金融产品部门员工发放总额达1亿美元的“留贤”奖金，而且，这只是今年发放奖金的第一轮，下个月可能还将发出另外一笔数千万美元。	发放	发放|发出	1
这位天体生物学者表示，第一批的“生命种子”是从38亿年前到达地球的，这些来自外太空的微生物随着彗星来到地球，然后不断成倍地繁殖进化并最终形成人类生命。	到达	来到|繁殖|形成	1
1981年，高英姬生下第一个儿子金正哲，1983年，又生下第二个儿子金正银。	生下	生下	1
2009年10月，IAEA为打破伊朗核问题僵局提出一份核燃料交换方案，表示伊朗可以先把低纯度浓缩铀运往俄罗斯，由俄罗斯加工成20%左右的高纯度浓缩铀，然后交由法国生产出核燃料棒，最后把这些燃料棒交还给伊朗用于研究用核反应堆。	运往	加工|生产	1
按照议程，与会者当晚将首先就当前全球经济和国际金融市场的形势举行工作晚餐，然后围绕七国集团未来的作用举行炉边谈话。	举行	举行	1
韩国统一部官员称，韩方在会谈上将就做为重启旅游项目的先决条件(查清朴旺子事件真相、出台防止类似事件再次发生的相关政策以及保障游客人身安全的措施)与朝方进行磋商。	出台	进行|磋商	1
乌克兰法律规定，总统选举每5年举行一次，候选人在第一轮投票中必须获得50%以上的选票才能当选，否则就要进行第二轮投票。	获得|当选	进行	1
乌克兰中央选举委员会估计，该国3700万选民当中，有约70%的选民参与了总统选举第二轮投票，比第一轮的投票人数增加了3.2个百分点。	参与	增加	1
亚努科维奇赢得乌克兰大选 面临政局混乱考验国际在线报道(记者金钟)：根据8号乌克兰中央选举委员会公布的初步计票结果显示，地区党领导人亚努科维奇在乌克兰总统选举第二轮投票中以微弱优势领先现任总理季莫申科，赢得大选。	公布	赢得	1
但是，初步计票结果不禁会让人们想起2004年11月乌克兰举行的总统选举投票，当时举行的也是第二轮投票，亚努科维奇也是以2%左右的微弱优势领先于尤先科，但是最终因一场突如其来的“橙色革命”，亚努科维奇并未登上总统宝座。	举行	领于|登上	1
据罗伯逊介绍，想要申请“最长寿”吉尼斯世界纪录的人首先要在他们的官网上提出申请，工作人员进行筛选后会挑出其中一些最具有可信度的申请，然后委员会才会派出系谱专家进行确认。	申请|提出	进行筛选|挑出|派出|确认	1
据悉，美国发展导弹防御系统的重点首先是保护美国抵御弹道导弹的袭击，然后削弱不断增长的地区性威胁，第三，在新导弹防御武器系统投入使用前，用实战测试武器，验证其有效性。	发展	削弱	1
安德里亚曼贾图12日在接受新华社记者电话采访时表示，他主张在马达加斯加议会选举之前，国内各政治派别首先实现和解，并在和解基础上组成联合政府，之后的议会选举才具有实际意义，而过渡权力机构内其他成员则坚持首先举行议会选举。	实现	组成	1
美国2名劫匪作案后遭警察追赶撞车身亡新华社专电 美国第二大城市洛杉矶14日发生一起车祸，两名先前抢劫情人节礼品摊贩得手的嫌疑人丧生。	作案|追赶|发生	丧生	1
但在20日上午，较为平静的巴北部城镇巴拉考特和曼塞赫拉的两个警察局先后遭袭，造成1名警官身亡、多名警察受伤，巴安全局势再次敲响警钟。	遭袭	敲响	1
而塔利班则一再拒绝卡尔扎伊的和解提议，称外国军队必须先从阿富汗撤军。	拒绝	撤军	1
不管各方反应如何，此举正值美国与拉美关系处于不详时期，首先是因为去年洪都拉斯发生军事政变后，双方在外交策略上存在分歧；其次是因为在美洲国家组织现任领导何塞•米格尔•因苏尔萨(Jose Miguel Insulza)下月可能再度当选的问题上存在分歧。	发生	存在|当选	1
据报道，俄罗斯舆论认为，尤先科祝贺亚努科维奇胜选的举动再次确定了亚努科维奇当选新总统的地位。	祝贺	当选	1
俄塔社称，尤先科是在当天季莫申科宣布撤销对亚努科维奇在大选中舞弊的指控之后不久向亚努科维奇表示祝贺的。	宣布|撤销	表示	1
奥巴马的新医改方案将使超过3100万目前尚未获保的美国人拥有医疗保险，在实施后第一个10年内将使美国政府预算赤字减少1000亿美元，在第二个10年内减少约1万亿美元。	实施|减少	减少	1
但是美国、韩国和日本拒绝朝鲜的这一建议，认为朝鲜必须首先履行弃核承诺，然后才能开始谈判和平协定问题。	履行	开始	1
新方案将斥资9500亿美元，计划在实施后第一个10年内将使美国政府预算赤字减少1000亿美元，在第二个10年内减少约1万亿美元。	实施|减少	减少	1
这是检察院对前总统塞拉亚提出的第二起指控公共开支腐败的案子，第一起腐败案还没有了结。	提出|指控	了结	1
现场一名目击者表示看到一名英国老先生突然闯入表演队伍，一把夺过别人手中的鼓，然后“狠狠踢了舞龙的尾巴”。	闯入	夺过|踢了	1
1.毛公仔旅行社公司大本营：捷克布拉格搞怪创意：玩具也能环游世界上月，捷克成立了世界上第一家玩具旅行社，专门带人类的毛茸玩具周游列国，然后把它们在旅游景点前的留影寄给主人。	成立	周游	1
迪拜警方表示，先前阿拉伯联合酋长国并未禁止，具双重国籍的以色列人可持他国护照入境，但今后阿拉伯联合酋长国不再欢迎他们。	禁止	欢迎	1
根据协议，第一场辩论将在英格兰西北部地区举行，由独立电视台进行直播，主要辩论包括国民医疗、教育在内的内政问题；第二场辩论将在英格兰西南部地区举行，由天空电视台进行直播，主要辩论包括伊拉克、阿富汗、伊朗在内的外交问题；第三场辩论将在英格兰中部地区举行，由英国广播公司进行直播，主要辩论包括金融危机、经济衰退在内的经济问题。	举行	进行|直播|辩论|举行	1
韩国重申先保障游客安全再恢复朝鲜旅游项目	重申	恢复	1
成立于2006年的自由党此次只在海牙和首都阿姆斯特丹东部小城阿尔默勒两个选区参加选举，最终在阿尔默勒大胜，成为当地议会第一大党，在海牙则成为第二大党。	成为	成为	1
韩国重申先保障游客安全再恢复朝鲜旅游项目新华网首尔3月4日电(记者 姬新龙)韩国统一部发言人千海成4日就朝鲜宣布恢复金刚山等地旅游项目表示，韩国政府认为应先解决保障游客安全问题，才能够恢复旅游。	重申	宣布	1
2006年他受到叛国罪的指控，成为美国二战之后半个多世纪以来遭到叛国罪起诉的第一人，如果罪名成立，他最多可能被判死刑。	受到	遭到	1
金刚山和开城旅游直接关系到韩国国民的人身安全，韩国政府坚持先解决保障游客安全问题，再恢复旅游的立场没有改变。	解决	改变	1
根据国会预算局当天公布的评估结果，如果获得通过，这份最终版本法案将在10年内耗资9400亿美元，它在生效后的第一个10年内有望使美国政府预算赤字减少大约1380亿美元，在第二个10年内减少约1．2万亿美元。	生效后的个10年内有望使美国政府预算赤字减少|减少	减少	1
“红衫军”的游街示威队伍首先在主集会场地繁华桥－耀马拉路口集结，然后沿着事先设计好的路线前进。	集结	前进	1
游街示威队伍首先在主集会场地繁华桥-耀马拉路口集结，然后沿设计好的路线前进。	集结	前进	1
国防研究与发展组织发言人萨拉斯瓦特对《印度教徒报》说，印度反导拦截网将分两个阶段部署：第一阶段主要拦截射程在2000公里以内的弹道导弹，第二阶段主要拦截射程超过2000公里的弹道导弹。	拦截	拦截	1
民调显示法国左翼政党在大区选举中大胜新华网巴黎3月21日电（记者彭梦瑶）法国大区选举第二轮投票21日晚结束，初步统计结果显示，主要反对党社会党为首的左翼政党在法国本土22个大区中的21个取得胜利，执政党人民运动联盟为首的右翼政党仅在阿尔萨斯领先左翼。	大胜	取得	1
内政部还说，这起事故是近两天里发生的第二起类似撞船事故，但内政部目前还未公开第一起事故的细节和伤亡情况。	发生	公开	1
机师后来根据标准作业程序，先预防性关掉出问题的引擎，然后进行紧急降落。	关掉	进行	1
卡尔扎伊在奥巴马抵达前1小时方接到通知中新社华盛顿3月28日电 (记者 吴庆才) 美国总统奥巴马28日突访阿富汗，这是奥巴马第二次访问阿富汗，也是其就任总统以及美军统帅后第一次访问阿富汗。	访问	访问	1
此前法新社报道称，莫斯科地铁29日第一次爆炸造成26人死亡，第二次爆炸造成15人死亡。	造成	造成	1
叶海林：第一次反恐战争把俄罗斯打疼了，这么大一个国家对付不了这么小的恐怖分子，俄罗斯人有同仇敌忾的心态，使普京基本完成了第二次车臣战争所起到的心理支撑非常重要。	打疼	对付|完成	1
协议规定，有意购买者需先向国际原子能机构总干事天野之弥递交正式申请，由天野之弥审核转交俄罗斯原子能公司，然后才能付款购买。	递交	转交|付款|购买	1
同时，法案在生效后第一个10年内有望使美国政府预算赤字减少1380亿美元，在第二个10年内减少约1.2万亿美元。	生效后个10年内有望使美国政府预算赤字减少|减少	减少	1
对于政府改变进攻计划，索马里总理萨马克表示，政府将先控制一小部分地区，然后逐渐扩大控制区域。	控制	扩大	1
迪拜欲再建世界第一高楼取代哈利法塔(图)国际在线专稿：继“哈利法塔”获得“世界最高建筑”这一头衔仅仅3个月后，阿联酋迪拜欲再建高楼。	再建|取代	欲建|建	1
泰国红衫军再次举行大规模游行集会新华网曼谷4月3日电 (记者 张秋来 史先振)支持泰国前总理他信的“红衫军”3日上午在首都曼谷再次举行大规模反政府游行示威，试图迫使政府同意在15天内解散国会下议院。	举行	举行	1
美国国际先驱论坛报向李光耀父子公开致歉赔偿中新网4月4日电 据南方周末报道，新加坡内阁资政李光耀父子日前再次把“西方媒体”告上新加坡法庭，美国《纽约时报》子报《国际先驱论坛报》公开向二人道歉，并向李氏父子和吴作栋支付16万新加坡元(约合78万元人民币)赔偿金，以弥补“名誉伤害”。	致歉	告	1
在莫斯科地铁站爆炸发生后第二天召开的交通安全会议上，俄政府总理普京要求完善交通安全保障体系，发展先进的视频监视系统、完善爆炸物检测技术手段以及人员救助和通知系统。	发生后第二天召开	完善|发展	1
调查发现，77%的成年人复活节期间不再要求子女限食巧克力，这样很多孩子复活节一早醒来第一件事就是狂吃巧克力蛋。	要求|限食	醒来件事就是狂吃|狂吃	1
在11日举行国会选举第一轮投票后，将于25日举行第二轮投票，初步选举结果于25日当晚公布。	举行	举行	1
匈牙利国会共有386个议席，第一轮投票产生了265个议席，其余的121个席位将在4月25日举行的国会选举第二轮投票中产生。	产生	产生	1
如果第一轮参选的候选人无一人能获得过半数选民投票，则将会进行第二轮投票。	获得	进行	1
艾哈迈德扎伊说，2008年夏天，他与先前已认罪的纳吉布拉·扎齐和另一名陌生人在巴基斯坦与“基地”组织头目会面，之后他加入塔利班，与驻阿富汗美军展开斗争。	会面	加入	1
瑞典国王卡尔十六世·古斯塔夫在1976年和王后西尔维娅结婚后，就废除了瑞典王子如果想要保留王位继承权和王室头衔、就必须和欧洲王室成员结婚的规定，接着瑞典又在1979年更改法律，规定王室长女也可充当王位第一顺位继承人。	更改	充当	1
欧盟国防部长会议认为，欧盟海军打击海盗的“亚特兰大行动”执行3年来取得了重大成果，第一年就使海盗发动袭击的次数减少了50%，第二年与上一年同期相比减少了25%。	减少	减少	1
美国与叙利亚的关系近日再次紧张，美方指责叙利亚和伊朗向真主党提供越来越先进的火箭和导弹，称这将破坏地区稳定。	紧张	指责|提供|破坏	1
围绕该方案，伊朗表示欧美方面关于将低纯度浓缩铀运往国外提纯加工为研究用核反应堆所需燃料棒后再运回伊朗的提议“不可信赖”，坚持必须先收到燃料棒再将浓缩铀运往国外。	收到	运往	1
泰选委会向最高检提交执政党献金案调查报告新华网曼谷5月10日电 (记者 史先振 张秋来)泰国选举委员会10日向最高检察院提交执政的民主党涉嫌非法收取政治献金案调查结果，再由最高检察院决定是否提请宪法法院解散这一政党。	提交	提请	1
数以千计久候的选民不耐烦陆续离去，有票站让他们先填好选票，待投票机修好，再由票站人员代投，专家担心此举可能会助长舞弊。	填好	修好	1
伊拉克发生数十起袭击114人死亡300人受伤中广网北京5月12日消息 据中国之声《新闻纵横》7时48分报道，就在世界各地刚刚欢度完母亲节的第二天，巴格达时间5月10日，从早晨到晚上，伊拉克首都巴格达、安巴尔省、尼尼微省、瓦西特省和巴比伦省先后发生20多起连环炸弹袭击或枪击事件，伊拉克安全局势顿时陷入一片混乱。	欢度	发生|陷入	1
在我将离任我生命中第二最重要的工作时，我更加珍视我的第一重要的工作，那就是当好丈夫和父亲。	离任	当好	1
公报说，英国石油公司正在继续打第一口“减压井”，第二口“减压井”也于16日动工。	打口	动工	1
实验中，科研人员先将“山羊支原体”的内部挖空，再向其中注入“蕈状支原体”的DNA(脱氧核糖核酸)，最后新的支原体终于开始自我繁殖，成为世界首个“人造生命”。	挖空	注入	1
军情六处获悉，参与的女性自杀式袭击者或许会先接受外科手术，把藏在胶囊内的烈性炸药“季戊四醇四硝酸酯”如隆胸般植入她们的乳房内，然后再像普通隆胸整容手术一般缝合伤口，使之成为两枚威力强劲的“乳房炸弹”！	接受	植入|缝合	1
3月8日，科纳特宣布几内亚将于6月27日举行第一轮总统选举，如果需要，第二轮总统选举将于7月18日进行，并承诺军政权不参加大选。	宣布|举行	进行	1
安瑞烈说，全国验票委员会将先拟订正副总统验票条规，并传唤选委会官员及自动化选举承包公司代表，就最近传出的一些舞弊说法进行调查，在排除一切疑虑之后，迅速进行票数的审核。	拟订	传唤|传出	1
报道指出，“农耕”是日本皇室严守的传统，每年的5月，天皇都会在皇宫的稻田里亲手种下稻苗，等秋收后，又亲自收割，然后把收割上来的稻米供奉在祖先的灵位前，用于祭天祭神。	收割	收割|供奉	1
高恩也承认，示威暴动阻碍泰国经济发展，第二季经济成长率预计会比第一季下滑，整体经济成长率会受到冲击。	阻碍	受到	1
由先锋派导演迪奇·詹姆斯创意策划的历史艺术游行紧接着拉开帷幕。	策划	拉开	1
记者在两个主要检查站之一目睹了几辆巴勒斯坦车辆接受检查的情况，先要出示身份证件，然后接受以军问话以及车辆检查，依次要打开后备箱，车前盖，车内肯定也是要检查的，每辆车差不多要查5分钟，之后放行。	出示	接受	1
该国的民航官员Monica Monje说：“沙子掉落在跑道上，我们需要先将其清理掉，然后才能允许飞机起降。”	清理	允许	1
她们父母的遗体最先被救援人员发现，之后救援人员继续进行搜救，结果发现了一只小手，之后看到了被一头棕黑头发半遮掩的小脸蛋。	发现	进行	1
 第一组乘员登陆火星表面后，火星模拟舱和其余设施之间的舱口由第二组志愿者立刻关闭，直到火星登陆模拟过程结束后才重新开启。	登陆	关闭	1
安理会理事国代表首先进行简短的闭门磋商，然后召开公开会议，联合国副秘书长米吉罗和土耳其外长达武特奥卢出席了会议。	进行	召开	1
朝鲜再次反对把天安号事件提交联合国新华网平壤6月4日电 (记者 高浩荣 赵展) 朝鲜外务省发言人4日在平壤发表谈话说，朝鲜坚决反对把“天安”号事件提交联合国安理会；即使提交安理会，也应该首先讨论朝鲜提出的派遣检查团问题。	提交	提交|讨论	1
他最初是一名市民运动家，1980年首次当选众议员，之后从社会市民联合组织并入新党“先驱”。	当选	并入	1
这是小斯塔夫斯基第二次遭绑架，第一次袭击发生在2009年2月，但被小斯塔夫斯基成功逃脱。	遭绑架	逃脱	1
据俄媒体报道，有俄方航天专家认为，“罗老”号发射失败有可能是第二级火箭提前启动或第一级和第二级火箭分离系统出现故障所致。	启动	出现	1
菅直人还表示，首先是阻止口蹄疫疫情扩大，口蹄疫疫情得到遏制之后，政府将全力支援受损农家的灾后重建。	扩大	得到遏制|遏制	1
当天，他先在密西西比州听取了美国海岸警卫队海军上将艾伦的救灾情况汇报，在与密西西比州当地民众会面之后，奥巴马前往阿拉巴马州，评估清理油污工作，随后他将前往佛罗里达并在那里过夜。	听取	会面	1
英国石油公司当天在一份声明中说，公司将取消原定本月21日发放的第一季度股息，第二和第三季度将不再公布股息派发计划。	取消|发放	公布	1
所以今天海沃德显然会少不了就事故的原因和英国石油公司之后在处置措施当中扮演的角色等一系列问题接受一轮又一轮的质询，要知道奥巴马早前在一次演讲当中就怒斥海沃德，批评他阳奉阴违，也是隐瞒一些实情，直言想炒了他，可见他在美国并不是很讨好，就连英国的媒体居然也是说，墨西哥湾漏油事故的罪魁祸首是海沃德，因为海沃德先前曾表态说我想要回到我正常的生活，这句话真的是激怒了不少的人，也包括美国的议员。	接受	怒斥|隐瞒|炒了	1
1517年，马丁·路德在威登堡教堂大门前钉上他所写的《九十五条论纲》，之后点燃宗教改革之火，造就了新教；1618年，波西米亚反对哈布斯堡王朝起义，欧洲陷入“30年战争”的利益争夺大混战中；1715年，汉诺威王朝兴起；1815年，欧洲反法同盟打败拿破仑后举行“维也纳会议”，重新划分欧洲势力范围图，维持了近一个世纪的和平；1914年则爆发了第一次世界大战。	点燃	造就了新教；1618年，波西米亚反对|反对|陷入|兴起|打败|举行|划分|维持|爆发	1
婚礼仪式首先将在大教堂举行，由瑞典大主教主持，之后新人将乘坐皇家马车在御林军马队陪护下到动物园，之后乘皇家瓦萨游艇，接受三军和宾客的礼遇，最后由水路返回王宫，婚礼晚宴将在王宫举行。	举行	主持，新人将乘坐|乘坐	1
最先发现的火星洞穴从2007年的美国地质勘探局科学家格伦库欣在火星其他区域发现的地质结构是比较类似的，按照库欣的说法火星洞穴可能是保有火星原始生命存在的证据，并且帮助人类登录火星之后抵挡宇宙的射线。	发现	登录|抵挡	1
路易斯安那州的霍恩贝尔服务公司最先就深水石油开采禁令提出起诉，之后10多个深水石油开采服务公司加入了这一法律行动。	提出	加入	1
德总统选举无人达到法定票数被迫进入第二轮6月30日，德国举行总统选举，本来有望在第一轮胜出的执政联盟候选人武尔夫意外没能获得绝对多数，选举被迫进入第二轮。	获得	进入	1
武尔夫仍是热门因为在第一轮选举中没有任何一位候选人获得623张支持票，因此选举进入第二轮。	获得	进入	1
玛格丽特·惠特曼6月8日赢得美国加利福尼亚州共和党州长提名，这标志着加州第一位女共和党员获得如此成就，这也是第一次有女候选人为竞选活动投入如此多的个人资金——据美国《福布斯》杂志于3月进行的财富估算，现年54岁的惠特曼身家约为13亿美元，迄今为止，她已为她的竞选花费了7000多万美元，并且有报道说，她愿意再投入这么多资金以求获选。	投入	花费	1
据韩国媒体报道，青瓦台高级官员表示，李明博将首先对青瓦台秘书班子进行改组，然后将着手包括国务总理在内的内阁大换班。	改组	着手	1
其中，被控充当美国间谍的俄罗斯核技术专家苏佳金已先行获释，8日从俄罗斯飞抵维也纳，然后将前往英国。	获释	飞抵|前往	1
在针对美军基地的袭击中，塔利班武装分子首先派装载着自杀式炸弹的汽车直冲基地大门，然后在门口将其引爆。	装载	引爆	1
《纽约时报》引述美国官员消息，最先提出交换人质的是美国，因为美国政府相信再扣押十人下去都没有用，因为他们提供的情报没有价值，认为反而值得利用他们与俄罗斯交换几个为自由抗争的囚犯。	提出	扣押	1
乌政治分析中心主任斯托亚金认为，执政的地区党在乌美军事合作方面的立场有所变化，亚努科维奇总统在形式上履行了竞选承诺，以立法形式放弃加入北约，巩固不结盟的内政外交方针，今后几年不会重提入约事宜，但是在更遥远的将来乌地缘政治优先方向可能会发生变化，有可能再次讨论入约问题，相关立场主要取决于乌领导人的观点以及俄罗斯立场的强硬程度。	发生	讨论	1
报道称，阿米里将首先前往“第三国”，然后再前往伊朗。	前往	前往	1
第一次通过该数据库进行“残酷睡客”身份确认并没有成功，但之后的尝试得到了答案。	进行	得到	1
第一个因漏油结晶导致漏油无法上输至海面船只，第二个只能收集部分漏油。	上输	收集	1
袭击者首先驾驶装有炸弹的汽车撞击引爆警察局大门及其附属建筑，然后埋伏在附近的武装分子蜂拥而出，使用机关枪和火箭筒猛烈攻击警局内人员。	驾驶|撞击	而出	1
虽然卡斯特罗自患病后不再担任古巴国务委员会主席的职务，但至今仍然是古共中央第一书记，并且还经常以《菲德尔同志的思考》为题发表系列署名文章，对国内外重大政治问题发表意见。	患病|担任	发表|发表	1
为使朝鲜半岛无核化进程再次进入轨道，应首先考虑建立朝美间的互信，而若要终止作为朝美敌对关系根源的停战状态，必须从缔结和平协定开始。	进入	建立|终止|缔结	1
据悉，两名绑匪在拿到安娜家人的1亿卢布“肉金”之后，吃喝玩乐大肆挥霍，先后购买了包括一辆奔驰在内的诸多奢侈品。	拿到	购买	1
一是从国际空间站“星辰”号服务舱外部取下一个旧摄像头，然后在其原来位置安装更加先进的摄像头，新摄像头主要用于监测欧洲自动货运飞船与国际空间站俄罗斯舱段的对接过程。	取下	安装|监测	1
评论说，若要朝鲜半岛无核化进程再次提上日程，首先必须要在朝美间建立互信，从中断朝美敌对关系的根源——停战协定，缔结和平协定开始。	提上	建立|中断|缔结	1
“控诉书”说，美韩7月25日至28日举行了挑衅性的大规模海上联合军演，从规模、内容、地点及过程等来看，此次联合军演都是为了对朝鲜发动先发制人的打击，是企图发动第二次朝鲜战争的前奏。	发动	发动	1
[普京先发制人]全国奔波展现“第一人”形象，为大选造势近日，俄罗斯饱受森林火灾的困扰，再加上前不久的间谍事件，普京开始频频出现在公众面前。	展现	饱受	1
梅德韦杰夫同时对海军总司令维索茨基和第一副司令兼总参谋长塔塔里诺夫提出“不完全称职”的警告，这种处分至少要背负一年之后才能撤销，在警告处分撤销之前海军总司令只要再犯下任何一个小错误，都有可能随时被免职。	提出	背负|撤销	1
换句话说，就是智障和残疾者每年可以在享受一些服务之后，在“以人为先”项目下报销账单。	享受	报销	1
奥巴马夫人米歇尔将带着9岁的小女儿萨莎，先去接正在参加夏令营的12岁大女儿玛丽娅，然后一起前往玛莎葡萄园岛与奥巴马会合。	参加	前往|会合	1
当前应该先缓和紧张的韩朝关系，再讨论“统一税”。	缓和	讨论	1
普京在当天的开工仪式上指出，沃斯托克尼发射场将在2015年发射第一个载人航天器，继而将在2018年之后承担发射俄罗斯所有载人航天器的任务。	发射	承担|发射	1
参加会谈的阿富汗各方也提出了自己的看法：首先北约和美军应该创造良好的气氛和环境，然后美军和北约要停止对阿富汗城市和人口集聚区的轰炸，释放关押的所有反对美军和北约以及阿富汗政府的抵抗人员。	创造	停止|轰炸	1
美国执行死刑，通常会在犯人的静脉中注射3种药剂，先注射硫喷妥钠使其沉睡，接着以肌肉松弛剂溴化双呱雄双酯让犯人肌肉麻痹、呼吸停止，最后注入氯化钾让犯人心跳停止。	注射|沉睡	溴化	1
此外，韩国行政安全部还指出，外交部在7月1日第一轮特别录用时将所有应聘者全部淘汰、在半月之后重新发出招聘公告的过程中也存在问题。	淘汰	发出	1
当天他听见第一声枪响，接着旅游巴前方楼梯井的一个人质倒下不动。	听见	倒下	1
此次召开的“非洲国王、王子、苏丹和酋长论坛”是第二届，第一次是去年9月9日在的黎波里召开的。	召开	召开	1
根据开发计划，第一阶段先发射首颗准天顶卫星“导”号，以验证补充和增强卫星定位系统功能的技术；随后将在评估第一阶段成果的基础上，进行第二阶段的发射。	评估	进行	1
东瀛游执行董事戤国全欢迎有关课程，认为有助提高前线员工的应变能力，但建议先培训旅行社部分人员，再由旅行社自行培训前线员工。	培训	培训	1
塔利班武装可以步行，可以骑驴，可以骑摩托运送武器弹药，而美军的战车再先进，也不可能在果园中穿行。”	运送	进，也不可能在果园中穿行|穿行	1
据报道，博斯沃思将于13日会见韩国署理外交部长官、外交部第一次官申珏秀，之后同朝鲜半岛和平交涉本部长魏圣洛进行会晤，对于重启六方会谈相关的问题，协调韩美两国立场。	会见	会晤	1
东京第一检察审查会此前就该案做出了“不起诉不当”的决议，再次传唤是检方重新展开调查的措施之一。	做出	展开	1
希拉里先前曾经强调，以巴必须掌握这次机会，因为可能不会再有和谈机会了。	强调	掌握	1
韩国制造了搭载卫星的第二级火箭推进器，俄罗斯制造了把罗老号射向太空的第一级火箭推进器。	制造	制造	1
作为缔约国，俄罗斯于2003年4月29日完成第一阶段销毁400吨化学武器的任务，于2007年4月完成第二阶段销毁8000吨化学武器的任务。	完成	销毁	1
中科院心理研究所危机干预中心主任王文忠说，“人在遇到危难之后，首先是惊恐，如果发现了希望，人就会极度亢奋。	遇到	发现|亢奋	1
第二版作出多处修改五角大楼发言人阿普利·库宁汉姆25日发布声明说，“国防部已经购买了这本书的第一版，原因是内容威胁到国家安全。”	作出|发布	购买	1
专业护理人员先行卫生部长马纳利奇对媒体介绍，救援开始后，一名矿井救援专家和一名专业护理人员将首先乘坐“胶囊”抵达地下，与矿工协商救援细节，之后33名矿工将依次升井。	乘坐|抵达	协商|升井	1
据巴西外交部指出，这项计划的目的是“提供海地学生养成协助国家社会发展的专业学识”，海地学生将先进入巴西大学学习4个月葡萄牙语，然后在工程、医学等科系就读1年，但不能领取毕业证书。	进入|学习	就读	1
美情报部门表示，基地组织计划向这些欧洲国家的首都街头派出恐怖分子，先是随意射杀行人，随后再前往标志性建筑作案。	射杀	前往	1
在总统选举中，巴西法律规定，如第一轮投票有候选人获得超过50%的选票，将直接当选；但如果无人得到超过半数的投票，则得票数最多的两位候选人进入第二轮投票，第二轮投票中得票多者胜。	获得	得到|进入	1
在步行了2小时之后，他终于走到了距离家8公里的一处指定投票站，平生第一次行使了政治权利。	步行	走到|行使	1
其中，第一次联合演习于2005年1月在印度举行，第二次于2007年9月在俄罗斯进行。	举行	进行	1
此后，澳大利亚再三表示，应先讨论“法律问题”再讨论减排数字。	讨论	讨论	1
这是自苏联瓦解之后，俄罗斯所打造的第一架全新战斗机。	瓦解	打造	1
乌干达军方发言人库拉伊戈耶(Felix Kulayigye)称：“我们只能说不能让2010年7月11日的惨剧再度发生，一些来自技术更先进、安全措施更完善的国家的人对我们发动袭击，虽然我们无法完全阻止，但我们应该尽量减少其发生。”	发生	发动|阻止	1
长途巴士先撞中一辆迎面而来的本田思域轿车，再撞向福利局巴士，然后翻覆在路中央。	撞中	撞向	1
事发时，一辆巴士由马六甲开往芙蓉的途中，不知何故失控撞向对面车道后，先撞向一辆本田思域后，再撞向一辆巴士并殃及4车。	撞向	撞向|殃及	1
法国民航总局呼吁计划于12日乘坐飞机出行的乘客先与航空公司联系，确认航班状态，然后再前往机场，以免造成不必要损失。	联系	确认|前往	1
出井后，矿工将先在矿区设立的野战医院接受医学检查，随后与家人短暂团聚，再由直升机送至附近科皮亚波的一家医院接受进一步医学观察。	接受	团聚|送至附近科皮亚波的一家医院接受|接受	1
出井后矿工将先在矿区设立的野战医院接受医学检查，  随后可以与家人短暂团聚，再由直升机送至附近科皮亚波的一家医院接受进一步医学观察。	接受	送至附近科皮亚波的一家医院接受|接受	1
目前，救援工作成功迈出第一步，救生舱接下来将继续放入井下，营救其余32名被困矿工。	迈出	放入	1
出井后，矿工将先在矿区设立的临时医院接受医学检查，随后可与家人短暂团聚几分钟，再由直升机送至附近一家医院接受长达48小时的医学观察。	接受	团聚|送至附近一家医院接受|接受	1
出井后，矿工将先在矿区设立的临时医院接受医学检查，随后可与家人短暂团聚几分钟，再由直升机送至附近一家医院接受长达48小时的医学观察。	接受	团聚|送至附近一家医院接受|接受	1
据报道，其中一名中了两枪的生还人质，警方初步相信第一枪是由门多萨发射，第二枪则较肯定是由菲警发射，该人质也确认枪手曾向自己开了一枪，但“第二枪的子弹是由窗外射进车内”。	发射	发射	1
早上6点07分，郝恒发出了有关智利铜矿营救的第一条微博，之后于10点27分发出了第一名救助人员成功下井的信息，于11点32分发出第2名救援人员被派下井的消息……	发出	发出	1
官员表示，武装分子先杀害了2人，再向北约军车投掷汽油弹，使车辆燃起熊熊大火，最终烧毁。	杀害	投掷	1
来自曼谷及其它地区的红衫军先在市中心集合，然后途径一座桥时，把红丝带系在栏杆上。	集合	途径	1
据悉，韩国联合参谋本部称，一旦进入“军事准备”，将先后进行强化韩美监视势态，升级地ㆍ海ㆍ空渗透及局地挑发待备势态，主要活动场所特别警护ㆍ警备ㆍ作战部队的预行练习及实际动员训练(FTX)，接着投入实际兵力。	进行	挑发|警护|投入	1
法国各工会先前酝酿，本月28日和11月6日再次举行全国性罢工和集会，试图说服萨科齐放弃退休制度改革或修改改革法案。	酝酿	举行	1
先是一名监狱看管人员在视察过程中，被囚犯袭击并夺走配枪，然后又遭射伤。	视察	袭击|夺走|射伤	1
法塔赫曾要求哈马斯首先签署开罗文件，然后双方讨论保留意见。	要求|签署	讨论	1
集会从11日中午开始，民众先在地铁首尔站举行大规模集会，4点半之后游行离开首尔站，排出近1500米长的队伍，向南荣站进发。	举行	离开	1
据报道，奥巴马在与梅德韦杰夫会晤后对记者说，“我再次重申对于在‘跛脚鸭’(指奥巴马在美中期选举中落败)议会期间完成对美俄削减核武器新条约的承诺”，“而且我已经把此事当做最优先考虑的要事与国会进行了沟通”。	完成	沟通	1
根据希腊的相关法律，如果在第一轮投票中出现候选人无一赢得过半选票的情况，当地将举行第二轮投票。	出现|赢得	举行	1
枝野在菅直人当选民主党党首后获重用，接任党干事长之职，在2010年9月菅直人再次当选党代表重组内阁与民主党人事时，干事长之职由菅直人第一内阁的冈田克也接任，而枝野改任干事长代理。	当选	接任	1
朝觐者须面向位于麦加大清真寺内的天房礼拜，然后站在阿拉法特山上诵念《古兰经》，以纪念先知穆罕默德在此发表临终演说。	诵念	发表	1
《新消息报》披露说，在作出上述决定前，内塔尼亚胡与多名内阁部长进行了反复协商，最后决定：在未来3年内，先让6000名埃塞俄比亚犹太人移居以色列，然后再让2000名犹太人从埃塞移居到以色列。	移居	移居	1
该消息人士称：“日本希望先拿回(4个岛中的)2个岛后，再让俄罗斯归还剩下的2个岛。	拿回	归还	1
分析称英国改革福利制度遏制依赖与滥用福利新华网伦敦11月16日电(记者 郭瑞)英国联合政府上台将近半年，改革福利制度重招频出，先是财政大臣奥斯本宣布对低收入阶层的租房补贴设定最高限额，就业与养老金大臣邓肯·史密斯又于日前公布以鼓励再就业为重点的福利改革计划。	宣布|设定	公布	1
先去掉皮毛和内脏，之后把各部位的牛羊肉分解开。	去掉	分解	1
先去掉皮毛和内脏，之后把各部位的牛羊肉分解开。	去掉	分解	1
报道说，奥巴马在新书中展现了更为柔和和绅士的形象，这或许是“再造”的第一步，希望借此能让民主党重新拉回一些女性选民的支持。	展现	拉回	1
报道称，此次大选是几内亚进行的首次民主选举，第一轮投票在6月27日进行，第二轮原计划于6月18日开始，但因种种原因推迟到11月7日。	进行	开始	1
该消息人士称：“日本希望先拿回(4个岛中的)2个岛后，再让俄罗斯归还剩下的2个岛。	拿回	归还	1
深圳特区报讯 尽管威廉王子和凯特接受媒体专访时都宣称结婚之后要先适应婚姻生活，然后才考虑生儿育女，但热心的英国电脑图像专家已经通过计算机科技为他们电脑模拟出了“未来儿女”的可能模样。	接受|宣称结婚之后要适应|适应	考虑	1
美批准第二起胚胎干细胞疗法临床实验本报洛杉矶11月22日电 (记者陈一鸣)据美国《科学美国人》网站22日报道，美国先进细胞技术公司已获得美国食品和药物管理局批准，将开展利用胚胎干细胞疗法治疗斯特格氏症的临床实验。	批准	获得|批准|开展|治疗	1
矿难救援进入搜索遗体阶段由于煤矿内24日发生了第二次爆炸，矿工们在第一次爆炸中幸存的希望破灭。	进入|发生	幸存的希望破灭	1
第二次大规模爆炸使所有这样的问题都失去了意义，因为如果有人在第一次爆炸中幸存，第二次爆炸也将使他丧生。	幸存	丧生	1
当时，朝鲜共进行了两次炮击，第一次炮击时发射约150枚，第二次发射了约20枚炮弹。”	发射	发射	1
据秘鲁警方透露，当日13时45分左右，武装匪徒冲进位于卡马拉街角的一家银行，首先将银行内的监视器砸毁，然后扣押了银行内的所有人员。	砸毁	扣押	1
而身为全球防治艾滋病大使的法国第一夫人布鲁尼则计划前往新德里一家基金会看望身患艾滋病的儿童，之后再访问当地一家医院。	前往|看望	访问	1
当地时间3日13时45分左右，一名武装匪徒冲进秘鲁首都利马卡马拉商业区的一家“大陆银行”，他首先将银行内的监视器砸毁，然后出示携带的炸药威胁人质。	砸毁	出示|威胁	1
当地时间3日13时45分左右，一名武装匪徒冲进秘鲁首都利马卡马拉商业区的一家“大陆银行”，他首先将银行内的监视器砸毁，然后出示携带的炸药威胁人质。	砸毁	出示|威胁	1
先是14时45分停止售票，并在16时10分请出最后一批游客，许多持票游客甚至不得再入内。	停止	请出	1
韩军指挥官会议称朝鲜再挑衅可先斩后奏环球网记者张哲报道 据韩国KBS电视台12月7日消息，韩国军方于7日举行全军指挥官会议，韩国国防部长官金宽镇在会议上指示，如果朝鲜再次进行“挑衅”，韩国将行使自卫权严厉应对。	挑衅	举行|进行	1
同时日本政府表示，根据修正后的数据，日本国内生产总值(GDP)至少在今年前9个月仍保持对中国的领先优势，日本也因此保住了世界第二大经济体的地位。	保持	保住	1
日本执法部门担心他出狱之后，山口组的暴力活动可能会失控，因此力求在筱田建市获释前，先重创山口组的组织结构。	出狱	失控|重创	1
1、老虎伍兹因对妻子不忠对所有人道歉前世界排名第一的高尔夫球手“老虎”伍兹，在性丑闻事件84天之后终于对妻子艾琳和孩子说了抱歉。	道歉	说了抱歉	1
据称老安帕图安告诉莫拉尔，可以先预付1000万比索(约152万人民币)，等越狱成功后再支付另外4000万比索(约609万人民币)。	预付	支付	1
此次公投遭到了马反对派的一致抵制，他们认为应首先成立由马四大政治派别共同组成的过渡政府，然后进行议会和总统选举。	成立	进行	1
“‘OpenLeaks’将不会直接发布信息，而是先取得信息再交由他人发布。”	取得	发布	1
他说，阿桑奇的“维基解密”网站就做两件事情：一是先从匿名泄密者那里得到秘密信息，然后就是将信息发布在一个未经审查的网站上。	得到	发布	1
俄日韩明年将在萨哈林岛再次举行海上联合演习环球网记者朱盈库12月16日报道，据俄新网16日报道，俄罗斯联邦安全总局边防局第一副局长瓦列里•苏尔坦申今天在新闻发布会上透露，俄日韩三国边防部门联合演习将于2011年在俄联邦安全总局萨哈林边防局下辖的沿海区域举行。	举行	举行	1
根据伊朗法律的规定，伊朗总统需要先向国会提出部长人选，获得国会批准之后方可生效。	提出	生效	1
记者：在梅德韦杰夫的访问行程确定之后，印度就有媒体总结了，在2010年，美国、中国、英国、法国和俄罗斯5个联合国安理会常任理事国的领导人先后成功对印度进行了访问，这是印度“大国外交”硕果累累的一年。	确定	进行|访问	1
萨科齐夫妇先是和孩子们一起在巴黎歌剧院观看演出，然后在爱丽舍宫共享美食大餐，夫妇两人还为每一名小客人派送了圣诞礼物。	观看	共享	1
当地警方官员法扎勒说，这名自杀式袭击者身穿巴基斯坦女性传统长袍，先是向人群中投掷了2枚手榴弹，然后引爆了自己身上的炸弹背心，袭击者应该是一名女性。	投掷	引爆	1
根据该方案，第一阶段将在法国建造两艘，以后还可能再建造两艘。	建造	建造	1
实际上我们知道李明博政府2008年上来之后，首先他要修改的一件非常大的工作，就是要修改陆武炫政府在2005年定的2020国防改革计划，在2009年6月16号李明博和奥巴马在白宫玫瑰园见面之后，回来十天后他就开始修改。	修改	见面	1
陆武炫当时，第一要裁军比较多，第二要把军队的关系捋顺。	裁军	捋顺	1
目前日本反导系统由两道防御圈组成，首先是由海上自卫队的宙斯盾舰进行拦截，然后再用从地面发射的“爱国者-3”反导系统击落“漏网之鱼”。	进行|拦截	击落	1
对此，达格萨家族发言人、达格萨妹妹罗萨里奥昨天对媒体表示，感谢媒体传播这张照片在抓捕凶徒过程中发挥的巨大作用，但凶徒已抓获，今后媒体如再刊发该照片，必须事先征得其家人同意。	刊发	征得	1
叶海林：在人民党失去了统一民族运动党之后，吉拉尼总理首先想到的是曾经的穆沙拉夫党，就是穆斯林联盟领袖派，领袖派主席舒贾特·侯赛因当过总理，因为领袖派大部分的党员和议员是从穆斯林联盟谢里夫派当中分裂出来的，这些人很清楚，如果他们加入到穆斯林联盟谢里夫派没有好果子吃，所以他们不太可能选择跟谢里夫合作，这样的一种利益需求使得舒贾特·领袖派的穆斯林联盟与人民党之间是有共识的，就是双方都不愿意看到谢里夫上台，于是人民党的130票加上反谢里夫舒贾特·侯赛因的55票，总共才达到185票，超过了执政所必须的172票，看起来这个联盟是稳定的。	失去	想到的是曾经的穆沙拉夫党，就是穆斯林联盟领袖派，领袖派主席舒贾特·侯赛因当过总理，因为领袖派大部分的党员和议员是从穆斯林联盟谢里夫派当中分裂|当过总理，因为领袖派大部分的党员和议员是从穆斯林联盟谢里夫派当中分裂|分裂|加入到穆斯林联盟谢里夫派没有好果子吃，所以他们不太可能选择跟谢里夫合作	1
穿上招牌红衣的红衫军先在民主纪念碑集合，然后游行到去年与军警对峙的商业区，现场交通一度受阻。	集合	对峙	1
穿上招牌红衣的红衫军先在民主纪念碑集合，然后游行到去年与军警对峙的商业区，现场交通一度受阻。	集合	对峙	1
突尼斯内政部说，8日夜里23点左右，位于突尼斯西部约200公里的省会城市卡塞林发生大规模骚乱，闹事者“以抗议失业和贫困为借口”聚众包围了当地警察局，“先是纵火焚烧了停在警察局门前的警车”，然后又挥舞棍棒试图冲击警察局。	焚烧	挥舞|冲击	1
突尼斯内政部9日发表的第二号新闻公报说，8日夜里23点左右，位于突尼斯西部约200公里的省会城市卡塞林发生大规模骚乱，闹事者“以抗议失业和贫困为借口”聚众包围了当地警察局，“先是纵火焚烧了停在警察局门前的一辆警车”，然后又挥舞棍棒试图冲击警察局。	焚烧	挥舞|冲击	1
一名目击者说，昨天上午，当枪手打完第一轮子弹准备再次装填弹匣的时侯，一位头部被子弹擦伤的男子冲过去抓住了枪手，接着一位中年妇女打掉了凶手的弹匣，随后周围民众蜂拥而上把枪手扑倒在地，有人乘势抢下枪支，枪手最终被制伏。	打完|装填	抓住|打掉	1
公报还说，韩国政府的立场是，如果要真正实现韩朝间对话，朝鲜首先应对“天安”号事件和延坪岛炮击事件采取负责任措施，并确保今后不再发生类似事件；其次要在无核化问题上表现出诚意。	采取	发生	1
公报还说，韩国政府的立场是，如果要真正实现韩朝间对话，朝鲜首先应对“天安”号事件和延坪岛炮击事件采取负责任的措施，并确保今后不再发生类似事件，其次要在无核化问题上表现出诚意。	采取	发生	1
日本首相菅直人宣布新内阁成员名单中新网1月14日电 据日本新闻网报道，当地时间14日中午12点45分，日本首相菅直人第二次改造内阁的新任内阁官房长官枝野幸男，在首相官邸举行第一次记者会，宣布新内阁成员名单。	改造	举行|宣布	1
沙特门户网站今天报道说，俄罗斯总统梅德韦杰夫下周将前往中东访问，他访问的第一站是巴勒斯坦，然后前往约旦。	访问	前往	1
沙特门户网站今天报道说，俄罗斯总统梅德韦杰夫下周将前往中东访问，他访问的第一站是巴勒斯坦，然后前往约旦。	访问	前往	1
沙特门户网站今天报道说，俄罗斯总统梅德韦杰夫下周将前往中东访问，他访问的第一站是巴勒斯坦，然后前往约旦。	访问	前往	1
先是加努希14日晚宣誓就任临时总统，接着宪法委员会15日宣布临时总统应由议长迈巴扎出任。	宣誓|就任	宣布|出任	1
位于法国东部的阿尔萨斯在1871年的德法战争中被德国吞并，第一次世界大战德国战败后阿尔萨斯回归法国，从1940年到1944年这一地区又被纳粹德国占领，第二次世界大战结束后阿尔萨斯再次成为法国领土。	战败|回归	占领|成为	1
另一名主持人在说到“山口先生回到长崎后，又再次遭遇了核弹爆炸”，演播室中再度扬起笑声。	回到	遭遇	1
日本方面记录显示，山口1945年8月6日在广岛出差，遭遇第一枚原子弹爆炸后遭烧伤，次日乘火车返回长崎，3天后再次遭遇原子弹爆炸。	遭遇	返回|遭遇	1
“红衫军”支持者当天下午先在曼谷主要商业区叻巴颂路口聚集，然后向曼谷民主纪念碑方向游行。	聚集	游行	1
日本方面记录显示，山口1945年8月6日在广岛出差，遭遇第一枚原子弹爆炸后遭烧伤，次日乘火车返回长崎，3天后再次遭遇原子弹爆炸。	遭遇	返回|遭遇	1
报道称，美国在注射死刑中通常会在犯人的静脉注入3种药剂，先注射“硫喷妥钠”使其沉睡，接着注射肌肉松弛剂“溴化双呱雄双酯”让犯人肌肉麻痹、呼吸停止，最后注入“氯化钾”让犯人心跳停止，而“喷妥撒”的主要成分就是“硫喷妥钠”。	注射|沉睡	注射	1
卡林还对与土耳其同为地震多发国的日本的抗震技术给予了肯定，称“第一座核电站由俄罗斯建造，但非常希望在锡诺普的第二座能由日本来建造”，并表示“若能在两三个月内达成协议，工程便可迅速推进。”	建造	建造	1
今天凌晨，在5名海盗抵达韩国之后，随即被用蓝色毛巾盖上手部，先被移送到韩国釜山地方法院接受调查，随后被押送到了南海海洋警察厅。	抵达	移送|接受|押送	1
海地临时选举委员会去年12月初决定成立由在第一轮投票中得票最多的3名总统候选人、国内和国际观察员以及国际社会代表组成联合委员会，对有关涉嫌选举舞弊问题展开调查，并对投票结果进行重新审核，并推迟了原定于1月16号进行的第二轮投票。	决定|成立	展开|调查|推迟|进行	1
先对这些社会群体横加指责，然后削减相关社会资金，必定会招致更多的怨恨。”	指责	削减	1
泰柬军队在边境争议地区再次发生冲突新华网曼谷2月7日电(记者史先振) 泰国和柬埔寨军队7日清晨在边境争议地区再次发生冲突，这是双方在4天内发生的第四次冲突。	发生	发生	1
在前两次冲突后，两国军队高级指挥官先后于5日和6日举行了两次会谈，表示将努力缓和两国边境地区紧张局势，避免再次发生交火。	举行	缓和	1
讪森说，泰国军方已关闭首先促动谈判的大门，除非柬方提出对话，否则泰国军队“绝不再率先要求对话”。	关闭	提出|要求	1
这位发言人还表示，韩方在有关天安号事件和延坪岛炮击事件上的立场没有改变，也就是说朝鲜必须得先进行道歉，并保证类似挑衅事件不再发生，朝方需要表示出诚意。	进行	发生	1
韩国方面则强调先谈“天安”号和延坪岛炮击事件，随后再磋商缓和军事紧张的问题。	强调	磋商	1
2010年5月10日 房利美称，今年第一季度继续亏损131亿美元，拟再次寻求84亿美元政府救助，这将使房利美接受的政府救助总额达到836亿美元。	亏损	寻求	1
金星焕说，朝鲜应当在实现无核化方面采取具体行动，首先举行南北对话，然后营造重启六方会谈的良好环境。	举行	重启	1
 《33》一书披露，在2010年10月矿工升井行动开展当晚，智利当局两次中断了现场直播，用事先录制好的镜头“接上”：第一次是矿井曾出现崩塌危险，连接井下和地面之间的缆绳甚至也被切断；第二次则是因为负责监控的海军方面人员与当地官员之间发生激烈争执。	出现	切断|发生	1
2012财年预算案规定优先支持谋求融入欧洲推进经济改革的国家，现在格鲁吉亚主要基础设施需求已经得到满足，自2008年与俄罗斯交战之后首要的重建任务已经完成。	支持	完成	1
一名目击者告诉新华社记者，他当时首先听到喀布尔银行内发生爆炸，然后看见武装人员和警察交火。	听到|发生	交火	1
首先，去年9月重新启动的巴以直接和谈再次陷入僵局的主要原因就是以色列继续在被占领土兴建犹太人定居点。	启动	兴建	1
首批83人今晨撤至埃及据新华社讯 第一批从利比亚撤离至埃及的83名中国公民，当地时间23日凌晨(北京时间今天早晨)从萨卢姆口岸进入埃及境内，并在中国驻埃及大使馆协助下转往埃及第二大城市亚历山大。	撤至	进入|转往	1
这是论文剽窃丑闻爆发之后，古滕贝格第一次公开露面。	爆发	公开	1
该检察厅说，将首先通过韩国金融监督院和德意志银行等提交的股市交易记录和邮件等资料了解事件的基本情况，然后对与涉嫌操纵股市价格等有关的5名德意志银行雇员进行调查。	提交|了解	调查	1
在众议院通过这项预算案之后，美国参议院多数党领袖里德表示，他也将推动预算案尽快在参院表决通过，并且在48小时内送交总统奥巴马签署，以赶在3月4日政府资金告罄的“最后期限”之前，让政府有足够资金维持运作，避免了联邦政府15年来第一次被迫关闭。	通过	推动|表决通过|通过|送交总统奥巴马签署，以赶在3月4日政府资金告罄|维持|关闭	1
按照计划，救援人员首先清理了湖中的各种垃圾，然后注入清水，并利用沙袋在湖中搭起一个小岛作为巨龟的“临时医院”。	清理	注入	1
韩国2月造船订单量超过中国 时隔4个月再次夺冠环球网记者朱盈库报道，据韩联社3月7日报道，韩国造船行业2月订单量时隔4个月赶超中国，位列全球第一。	超过|夺冠	赶超|位列	1
法国前总统希拉克所涉弊案再度推迟审理中新社巴黎3月8日电(记者 卫中) 负责审理法国前总统希拉克涉嫌弊案的巴黎轻罪法庭8日作出裁决，决定接受被告辩护律师的意见，就其提出的案件诉讼时效“合宪性先决问题”进行审查，因而推迟对法国前总统希拉克等被告的庭讯。	推迟|审理|作出	接受|推迟	1
这次内乱就是由第一大部落——瓦法拉反对卡达法部落的统治，拉拢第二大部落——图阿里而发起的。	反对	发起	1
日本首相菅直人先后宣布福岛第一和第二核电站进入“原子能紧急状态”。	宣布	进入	1
一名地震海啸监视官员称海啸的第二波、第三波的海浪有可能变得更高，第一波海啸没有到达的地方也有可能遭遇巨大海啸袭击。	变得	到达|遭遇	1
此前，东京电力公司已通报福岛第一核电站1号和2号机组、第二核电站的1号、2号和4号机组出现故障的情况。	通报	出现	1
此前，东京电力公司已通报福岛第一核电站1号和2号机组、第二核电站的1号、2号和4号机组出现故障的情况。	通报	出现	1
这位府尹称，如果有在该府建设核电站的计划，必须首先举行公开听证会并征得当地人民的同意，然后再交由内阁会议批准方可实施。	举行|征得	批准|实施	1
这位府尹称，如果有在该府建设核电站的计划，必须首先举行公开听证会并征得当地人民的同意，然后再交由内阁会议批准方可实施。	举行|征得	批准|实施	1
据共同社报道，东京电力公司工作人员于当地时间15日凌晨1时开启福岛第一核电站2号机组核反应堆释放气体降压的安全阀门，再次进行注入海水作业，截至凌晨3时，反应堆容器内部压下降，由此推断海水已经成功注入。	开启	进行	1
7名国际专家组成灾害评估小组抵达日本已发生爆炸的一二三号机组仍不稳定五六号机组核燃料棒温度不断上升福岛核电站4号机组上午再起火放弃用直升机注水方案东京核辐射值出现回落各地每天两次公布监测数据日本东京电力公司16日上午称，该公司员工当天早晨看到福岛第一核电站4号机组核反应堆所在的建筑4层西北角附近出现火焰，随即向消防部门报警。	组成|抵达|发生爆炸的一二三号机组仍不稳定五六号机组核燃料棒温度不断上升福岛核电站4号机组上午再起火放弃用直升机注水方案东京核辐射值出现回落各地每天两次公布	看到|出现|报警	1
李润泽认为，大灾之下最担心的是两点，第一是基础设施的破坏，对灾区的影响很大，会导致救灾物资无法及时发放；第二就是心理上的失衡，尤其是大都市的居民，首先在东京，如果离东京较近的关东地区其他城市都发生抢购，就会发生非常可怕的暂时的物资短缺，如果再影响到民众的心理，会形成恶性循环。	破坏	影响很大，会导致救灾物资无法及时发放|发放	1
日本福岛第一核电站4号机组再度发生火情中新网3月16日电 据共同社最新消息称，当地时间16日清晨5时45分，日本福岛第一核电站4号机组再次发生火情。	发生	发生	1
2011年第一艘该级别巡航导弹核潜艇“北德文斯克”号将建造完毕，同时继续建造名为“喀山”号的第二艘该级别现代化核潜艇。	建造	建造	1
19时35分，第一辆消防车向3号反应堆喷水；19时45分，第二辆消防车开始喷水；19时53分，第三辆消防车开始喷水；20时00分，第四辆消防车开始喷水；20时07分，第五辆消防车开始喷水；20时09分，所有5台消防车喷水作业停止。	喷水	喷水	1
先检查坍塌建筑物，再查探遭淹汽车，接着转向碎石堆。	检查	查探	1
日本福岛第一核电站周边辐射值有所降低国际在线消息 (记者王洋)：日本经济产业省原子能安全保安院18日上午召开记者会说，在17日对福岛第一核电站3号机组实施注水作业之后，核电站周边的辐射值有所降低，但是否是注水作业起到了一定的效果还无法确定。	降低|召开	实施	1
东京消防厅18日上午向福岛第一核电站派出可以从高处注水的特殊消防车，自卫队的消防车已在福岛核电站附近待命，准备于当天下午再次对3号机组进行注水作业。	派出	待命|进行	1
险情链接福岛第一核电站6个机组险情频现●1号机组3月12日下午，发生氢气爆炸；●2号机组3月15日上午，发生爆炸3月18日，冒出浓烟●3号机组3月14日，发生氢气爆炸3月16日，再次发生氢气爆炸●4号机组3月15日，氢气爆炸，有起火现象3月16日，再次起火●5号机组3月16日，水池温度轻微上升●6号机组3月16日，水池温度轻微上升新闻链接切尔诺贝利石棺1986年4月26日，苏联切尔诺贝利核电站发生泄漏，造成30人当场死亡，8吨多强辐射物泄漏。	频现	发生	1
贝宁宪法规定，如果没有任何候选人在第一轮投票中获得绝对多数，第二轮投票将在第一轮投票中领先的两位候选人之间举行。	获得	举行	1
美国担忧，阿里斯蒂德在3月20日海地总统选举第二轮投票前回国可能引起政局动荡，影响选举结果，先前多次施压，试图阻止后者返回行动。	回国可能引起|引起	施压，试图阻止|阻止	1
福岛核电站两座反应堆冒烟致抢险工作中断人民网3月21日电 日本福岛第一核电站3号和2号反应堆21日先后冒出浓烟，正在现场架设供电线路的抢险人员被迫紧急撤离，造成反应堆降温工作再度暂时终止。	冒烟|冒出	架设|撤离|终止	1
九州电力公司表示，福岛第一核电站仍处于不稳定状态，政府目前也正重新审视核电站的安全标准，因此公司还需要待政府有了更清晰的政策取向后才会开始再次运作这两个机组。	处于	重新审视|审视|有了更清晰的政策取向后才会开始次运作|运作	1
据俄罗斯通讯社报道，内塔尼亚胡在会见俄罗斯总统梅德韦杰夫时表示：“希特勒想首先征服世界，然后开始研制核武器，哈梅内伊的步骤与之相反”。	征服	研制	1
法国《时事观点》不该干涉六理由第一，军事干涉对利比亚人民并无好处，更别提人道主义援助了；第二，军事行动的目标并未明确，美军及其盟国希望利比亚未来局势如何发展？	干涉	干涉	1
卡塔尔成为继法国之后，世界上第二个承认该委员会的国家，同时也是第一个承认利比亚反政府武装的阿拉伯国家。	承认	承认	1
28日，卡塔尔成为继法国之后，第二个承认利比亚反对派临时政权为该国合法代表的国家，该国也是第一个承认利比亚反对派的阿拉伯国家。	承认	承认	1
今晨法国兴业银行发布的“日本灾后复苏影响报告”显示，由于私人消费、库存和出口的下滑，日本第一季度经济将出现下滑，预计第二季度反弹。	出现	反弹	1
目前警方正在讨论是否要先将遗体进行清洗和去除辐射等措施后再交由有关人员下葬。	讨论	下葬	1
由于联合国在利比亚设立禁飞区，周三变节的外长库萨等人都是首先经过陆路进入邻国突尼斯，然后再飞往其他国家。	进入	飞往	1
对于东电公司未能快速控制第一核电站的情况，且情况日益恶化的局面，鼓纪男表示，“我只能说我们在全力以赴地解决问题，相信再等待一阵，这个情况就会好转”，他并强调“在我看来，东电一直在为尽快控制事态而拼命努力”。	控制	恶化|解决	1
该省一名军官告诉新华社记者，部落武装分子先将该公司包围了数小时，然后发动了进攻，试图冲进公司大楼内，随后该公司的守卫击退了武装分子的进攻，目前没有伤亡报告。	包围	发动	1
2009年秋天，联盟党和自民党联合政府决定，暂不正式施行该法令，而是先采取一年的试行期，由原来的“封锁”儿童色情网页改为“删除”网页，随后再视试行期删除网页的效果以决定后续措施。	采取	改为“删除”网页，随后视试行期删除|决定	1
日本福岛核电站拟再建两座核反应堆遭民众反对就在日本福岛第一核电站险情不断，大量放射性废水流入太平洋的时候，负责电站运营工作的东京电力公司仍制定了“扩建核电站的计划”：为福岛第一核电站增加两座核反应堆。	再建	流入|制定|增加	1
日本计划在福岛核反应堆外设室外冷却系统中新网4月6日电 据日本新闻网报道，由于日本福岛第一核电站的几个核反应堆的冷却水供应系统依然无法恢复正常，加上反应堆内核辐射量过高，无法让技术人员入内进行设备抢修，为此，日本政府正在考虑，在第1至第3核反应堆的建筑物外部，设置新的冷却水供应系统，以便防止原子炉再度出现高温问题。	恢复	设置	1
最高人民会议代表经朝鲜全国选民直接普选产生，任期五年，现任的第十二届最高人民会议共由687名代表组成，2009年4月举行过第一次会议，之后2010年4月和同年6月分别举行过第二次和第三次会议。	举行	举行	1
核安全标准低 埋下危机隐患首先，日本的核电工业是二十世纪五十年代中期起步的，起步之后可以说步步都是有法可依的。	埋下	起步	1
他将从4月15日起先后访问捷克、匈牙利，并将在访问乌克兰之后前往俄罗斯。	访问	访问|前往	1
日本福岛核电站上月发生爆炸事故之后，古里第一机组的延长运作在韩国国内引发有关核电安全的争议。	发生	引发	1
美国会通过2011年联邦政府预算案 中新社华盛顿4月14日电 (记者 吴庆才)在两党上周达成妥协之后，美国国会众、参两院14日先后通过2011财年剩余半年的联邦政府预算法案，这意味着联邦政府在未来半年将不会有“断炊”的危险，80多万公务员也不会因联邦政府关门而“被休假”。	通过|达成	通过	1
即王位应先由现任君主的长子继承，然后才依次序轮到其他儿子，最后才轮到女儿。	继承	轮到	1
英国民众热议修改王位继承顺序距离英国王位第二顺位继承人威廉王子的婚期尚有十余天，英国民众则在热议：如果威廉王子婚后第一胎喜获千金，能否让这个小女孩继承王位的顺序往前挪？	修改	喜获|继承	1
东电说，将集中力量首先处理2号机组内积水，再应对4号机组积水。	处理	应对	1
他指出，军演与最近政局走势一致，在解散国会以前，先撤销“红衫军”领袖的保释，接着发动政变。	撤销	发动	1
马渊澄夫还透露，东京电力公司将首先落实把反应堆所在建筑罩起来的工程，然后再开始建造地下拦水墙。	落实	建造	1
阿披实称他已被告知24日边境再生冲突的信息，这位总理说，泰国没有也不会首先向柬埔寨挑衅，冲突都是由柬埔寨引起的，泰国方面只是采取了自卫行动。	告知	挑衅|采取	1
继运行航天飞机30多年之后，美国航空航天局修改先前制定的载人航天计划，与多家私营企业签订合同，资助这些企业研制“太空巴士”，用于运送宇航员往返空间站。	运行	修改|签订|资助|研制|运送	1
计票首先看是否有候选人获得“第一选项”数量过半，过半即当选；如果无人过半，获“第一选项”最少的候选人遭淘汰，这名候选人所得“第一选项”的选票分配给同一张选票中获“第二选项”的候选人；再重新计票，看是否有候选人获“第一选项”数量过半；如果没有，重复上述过程，直至有一名候选人获“第一选项”过半。	淘汰	分配	1
“无心插柳柳成荫”，没想到，这首没有豪言壮语，只有8句歌词的童谣在北京经过4轮PK，以第一名的成绩进入了全国的决赛，如今再过次五关斩六将，进入最后的36首入围歌曲之一。	进入	过次	1
自2010年12月以来，巴基斯坦国内政局出现剧烈动荡，先是以穆盟(谢里夫派)为首的反对派频频向联邦政府发难，并将人民党势力排挤出旁遮普省政府，随后，执政联盟内部出现分崩离析的趋势，伊斯兰神学会、统一民族运动党等纷纷宣布退出执政联盟，一时间使孤掌难鸣的人民党政府地位岌岌可危，虽然后来通过政治斡旋暂时渡过了难关，但以人民党为首的联合政府始终受到来自各方的强大压力。	发难	排挤|出现|宣布|渡过	1
虽然韩国政府一再重申，朝鲜必须先在无核化方面采取实质性措施，并就“天安”号事件和延坪岛炮击事件道歉，但是这两天韩国方面还是采取了一些缓和局势的行动。	重申	采取|采取	1
泰柬边境爆发新一轮冲突 1名泰国军人阵亡新华网曼谷4月29日电(记者史先振)泰国军方29日说，泰国和柬埔寨军队28日夜间至29日凌晨在边境地区再次发生交火，造成一名泰国军人阵亡、4人受伤。	爆发|阵亡	发生	1
福岛第一核电站发生事故后，这处污水处理设施已向水泥公司提供了约500吨污泥，福岛县目前已停止污泥的再利用，并追踪调查之前运出污泥的使用情况。	发生	提供|停止	1
白宫还披露，此次共有20多名美国海军“海豹”突击队成员携带先进战斗装备，首先乘坐多架“黑鹰”直升机从阿富汗飞抵巴基斯坦首都附近，然后立刻掉头前往距当地50多公里的北方城市阿伯塔巴德“消灭拉登”。	乘坐|飞抵	前往|消灭	1
之后才能接受普通大学的高等教育，先后在马德里自治大学法律系和美国华盛顿乔治敦大学外交学院研究生班学习。	接受	学习	1
柬埔寨首相洪森在当天召开的新闻发布会上表示：“我之所以把这一问题提出来讨论是因为泰国迟迟不愿意签署同意印尼派遣观察员的协议，泰国希望能够在签署这一协议之前举行仅限于泰柬双方举行的边境常务委员会会议，而柬埔寨的立场是印尼必须先派遣观察员进入争议地区，然后才举行这一会议。	派遣|进入	举行	1
接受印尼做为观察员国的决定早在今年2月就已经做出，因此在泰国签署这一协议之前，没有资格再提出有关撤军和先举行边境常务委员会会议的要求。	签署	提出|举行	1
不过，尽管机械师们放弃了罢工的想法，但仍有大约2500名乘客因航班先取消后再重新安排而受到影响。	取消	受到影响|影响	1
据悉，东电将首先在1号机组反应堆所在建筑外部建造钢铁构架，然后再在上面罩上聚酯纤维。	建造	罩上	1
地球先是会发生巨大的地震，之后这里将不再适合居住。”	发生	适合居住|居住	1
萨利希是自两国发生间谍纠纷之后，第一位访问科威特的伊朗外交官。	发生	访问	1
他说，2008年11月他在华盛顿召开的会议上第一个报告了拉登死亡时间，这之后美国人开始跟踪其联系人。	召开|报告	跟踪	1
美国和北约的武器弹药和粮草先通过海运到达巴基斯坦南部最大的城市卡拉其港口，再通过火车和大型运输卡车运送到阿富汗。	到达	运送	1
福岛第一核电厂二三号机组发生堆芯熔毁现象中新网5月24日电 据“中央社”报道，东京电力公司24日宣布，福岛第一核电厂继1号机之后，2号机和3号机也发生堆芯熔毁现象。	发生	宣布	1
此次抗议活动由土耳其民间组织人权基金发起，他们表示将在6月底向加沙地区再次派遣国际救援船队，其规模将超过第一次，由15艘船和1500名活动分子组成。	派遣	组成	1
这位发言人说，朝鲜国防委员会对此阐明如下原则立场：朝鲜军队和人民同李明博政府“将不再接触”；将发动全民族的攻势，给李明博政府的反朝活动画上句号；朝鲜军队和人民将对李明博政府的对峙活动采取实际措施，作为第一步，朝鲜军队将切断东部地区朝韩军事通信线路，并关闭金刚山地区的通信联络所。	发动	画上|切断|关闭	1
21日晚，也门反对派率先在海合会提出的调解协议上签字，也门执政党代表22日也签署了这一协议，但萨利赫22日下午再次拒绝签署调解协议。	签字	签署|拒绝签署|签署	1
菅直人在与在野党党首辩论中再次拒绝下台中新网6月1日电 据日本共同社报道，日本首相菅直人1日在与各在野党党首辩论时再次拒绝下台，强调朝野双方应联手应对东日本大地震灾后重建和福岛第一核电站事故。	拒绝	应对	1
据报道，双方决定先调查被指曾掩埋化学物质的直升机场等三处，若有新的可靠信息再对基地内其他点进行调查。	调查	调查	1
突尼斯民族团结政府司法部发言人卡齐姆·扎因·阿比丁说，本·阿里夫妇所涉第一起案件是调查人员在本·阿里位于迦太基的私人住宅发现武器和大约两公斤毒品，第二起案件是在首都突尼斯城郊区总统官邸发现2700万美元现金。	发现	发现	1
此外，由于福岛第一核电站产生的核素钚在厂区外被发现等，事故平息遥遥无期，再加上东电2011财年财报预期，除去事故赔偿后的净亏损约达5700亿日元(约合人民币460亿元)，投资者对其经营前景的担忧日益高涨。	发现	平息	1
自五月初德国出现大面积EHEC病菌传染之后，该病菌首先在西班牙进口黄瓜上被发现，后被实验室证实黄瓜上病菌和致病病菌并非同一支。	出现	进口|发现	1
秘鲁举行总统选举第二轮投票新华网利马6月5日电(记者贾安平 张国英)秘鲁5日举行总统选举第二轮投票，首轮选举得票领先的“秘鲁胜利”联盟候选人胡马拉和“2011力量”党候选人藤森庆子将进行最后角逐。	举行	进行	1
第一次不信任案已于6月2日被否决，若按照原定日期休会，在野党与民主党部分议员将在不久后或会联合要求召开临时国会，届时菅直人将再次面临一次不信任案的“倒菅”行动。	否决	休会|召开|面临	1
据报道，为应对日本一再主张对“独岛”领土主权，韩国政府于4月4日到5月21日在天安独立纪念馆举行了第一次“独岛”展。	主张	举行	1
如果这些“用电大户”在措施实施后的第一个月不能严格执行限电措施，他们将支付额外的10%电费，之后每月支付的额外费用将增加5%，一直到这些单位成功限电为止。	实施|执行	支付|增加	1
在英国，国际货币基金组织对政府关于财政紧缩的第一方案表示有保留的支持，但另一方面又说，如果经济增速进一步放缓，可能需要第二方案。	表示	放缓	1
日本福岛核电站净水系统再次发生故障日本东京电力公司16日晚说，福岛第一核电站新安装的高辐射污水净化系统当天在试运转中出现漏水，恐怕无法按计划17日下午开始正式运转。	发生	安装|出现|开始	1
共和党众议员伊斯雷尔16日接受美国有线电视新闻网(CNN)采访时说，根据他所掌握信息，韦纳现在最关心的不是如何重返政界、东山再起，而是如何修补家庭关系，与妻子一起迎接第一个孩子。	重返	修补|迎接	1
共和党众议员伊斯雷尔16日接受美国有线电视新闻网(CNN)采访时说，根据他所掌握信息，韦纳现在最关心的不是如何重返政界、东山再起，而是如何修补家庭关系，与妻子一起迎接第一个孩子。	重返	修补|迎接	1
日本超越中国重夺超级计算机第一新华网北京6月21日电 根据全球超级计算机500强排行榜的最新排名，世界上最高速超级计算机的桂冠再次易主。	超越|重夺	易主	1
反对派要求政府首先释放所有政治犯，军队从动乱城镇撤离，允许和平示威游行，然后进行民族对话。	要求|释放	撤离|允许|进行	1
与此同时，民族联合党人佩卡·拉维当选为芬兰第一副议长，第二副议长由正统芬兰人党成员安西·约岑拉赫蒂担任。	当选	担任	1
南非约翰内斯堡金山大学(Witwatersrand University)的生物学家撒克里(Francis Thackeray)及研究团队向英国国教会提出正式申请，要求挖掘莎士比亚位于史特拉福当地教堂的坟墓，再利用最先进的3D科技，重现莎翁形象。	挖掘	重现	1
萨普比被处决后，印尼政府通过外交渠道向沙特表达了抗议，沙特方面也因为处死女佣前没有事先通报而正式向印尼道歉，并承诺不再发生类似事件。	处死|道歉	发生	1
他说：“我们都已经是老人，不再担忧核辐射问题，我们将尽自己的智慧和技术，为扑灭福岛第一核电站的核泄漏问题作最后的贡献。”	担忧	扑灭	1
东电派出的第一辆应急供电车因交通阻塞，没能抵达核电站；第二辆应急供电车23时抵达，因电缆太短而无法与机组联机。	派出	抵达	1
目前，“联邦”基金会计划在莫斯科再次发起慈善音乐会，此次内容主要是帮助医院购买先进设备，组织方称已邀请达斯汀·霍夫曼、伍迪·艾伦、凯文·科斯特纳，索菲亚·罗兰，卡雷拉斯以及拉里金等诸多明星，据称这些应邀参加明星要为医院捐助10万美金或物资用于购买所需设备。	发起	帮助|邀请|购买	1
他先前宣布，有意2012年再次谋求一届6年总统任期。	宣布	谋求	1
日本东京电力公司说，地震没有致使福岛第一和第二核电站出现异常。	致使	出现	1
当天傍晚6时54分，孟买南部拥挤的扎韦里市场发生第一起爆炸；1分钟后，孟买南部的歌剧院地区发生了第二起爆炸；11分钟后，即7时06分，孟买中部火车站附近的达达尔地区的一个公交站附近发生了第三起爆炸。	发生	发生	1
新华社译名室：周总理亲定的“人名海关”【作者】陈娟《国际先驱导报》文章“A-c-c-o-y-e-r……”这样零星的字母发音，不时从一个房间飘进另一个房间，之后或许就会有一场争论。	亲定	飘进	1
在去年4月苏丹举行大选之后，苏丹人民解放军中的至少6个派别以南苏丹执政的苏丹人民解放运动和南苏丹最大部族丁卡族独揽政权为由先后发动叛乱。	举行	发动	1
当天，此人先在奥斯陆市中心引爆炸弹造成7人遇难，然后伪装成警察跑到郊外森林夏令营中大开杀戒，又打死10名无辜青少年。	引爆|造成	跑到郊外森林夏令营中大开	1
他先是向地面上的人扫射，接着向那些跳水逃生的人射击。”	扫射	射击	1
纵火犯不仅再次将一个垃圾桶引燃并推至后门，还企图点燃邹先生的Nissan轿车。	推至	点燃	1
现年56岁得吴振伟祖籍中国江苏苏州，出生于台湾新竹，六岁随家人移居美国，1998年当选为美国第一位华裔联邦众议员，之后七度连任。	当选	连任	1
共和党提出一个短期方案，主张先期提高债务上限1万亿美元，并在10年内减赤1.2万亿美元，但明年2、3月份必须再就提高债务上限问题进行谈判。	提高	减赤|进行|谈判	1
共和党提出一个短期方案，主张先期提高债务上限1万亿美元，并在10年内减赤1.2万亿美元，但明年2、3月份必须再就提高债务上限问题进行谈判。	提高	减赤|进行|谈判	1
据日本广播协会电视台报道，地震发生后，经济产业省原子能安全保安院没有接到福岛第一核电站和福岛第二核电站发生异常的报告。	接到	发生	1
窃听事件入狱侦探称窃听为他人授意窃听风云据新华社电 先前因窃听事件入狱的私人侦探格伦·马凯尔当天发表声明，称自己的窃听行为属他人授意，再次把新闻集团高层推上风口浪尖。	发表	推上	1
根据博纳的新债务上限方案，美国国会将分两步走上调政府债务上限，今年先上调9000亿美元，同时削减赤字9170亿美元，再于明年2月商讨上调1.6万亿美元，前提是通过国会平衡政府预算的宪法修正案。	上调	削减|商讨	1
从1日开始的一周内，洪博培将在新罕布什尔州展开密集行程，首先是参加一个儿童科学教育组织的活动，然后连续上门拜访选民家庭，参观当地工厂，与商界领袖会晤。	参加	拜访	1
双方参演人员将首先在俄边境城市恰克图完成准备，然后进入蒙古国境内进行演习。	完成	进入|进行	1
泰国国会下议院预计本周选举新总理人民网曼谷8月2日电(记者 孙广勇)2日，泰国第二十四届国会下议院第一次会议在曼谷举行，会议选举颂萨·革素拉暖为国会下议院议长兼国会主席，乍龙·占哥蒙及威素·差纳伦为副议长。	选举	举行	1
也门内政部的一名官员告诉新华社记者，反对派部落武装首先向正在巡逻的士兵开火，导致双方激烈交火，政府军随后派遣大量支援部队进驻哈萨巴区，当地局势再度紧张。	开火	激烈交火|交火|派遣|进驻	1
他6月20日在古巴手术摘除了恶性肿瘤，随后于7月16日再赴古巴接受第一阶段化疗。	摘除	再赴古巴接受|接受	1
李绍先： 如果说现在各派同意萨利赫作为名誉援手，然后在年底之前进行大选，我觉得这是一个软着陆的方案，应该向这个方向努力，我相信是这样：现在先不做答复，如果说能达成这背后有很深刻含义，也就是说它很大程度上代表了背后的沙特阿拉伯，背后的海湾合作委员会的力量，海湾合作委员会背后实际上有美国，所以对萨利赫来讲未必不是一个好的选择。	同意	进行	1
另据美联社报道说，第一次爆炸使用了遥控炸弹，而第二名自杀式袭击者则事先投掷了一枚手榴弹试图以此引爆炸弹背心。	使用	投掷|引爆	1
这已经是洪森第二次向英拉发去贺电，第一次是在一个月前英拉领导为泰党在泰国国会下议院选举中赢得组阁必须的过半数席位之时。	发去	赢得	1
季莫申科再度受审 乌克兰前总统出庭作证中新网8月17日电 据俄新社记者报道，17日，乌克兰前总理尤利娅·季莫申科就越权、贪污等指控出席庭审，乌前总统维克托·尤先科抵达基辅佩克斯克拉地方法院，为季莫申科案件作证。	受审	出席|抵达|作证	1
哈扎尔先是前往甘地墓，经由印度门，然后才到达绝食活动地点。	前往	到达	1
另一消息人士说，金正日可能在20日早晨搭乘专列从朝鲜出发，先进入朝俄边境城市哈桑，之后前往海参崴。	进入	前往	1
三天来，拜登在华的行程安排非常丰富：第一天抵达北京后以观看一场中美篮球友谊赛“轻松开场”；第二天忙里偷闲到北京小吃店用餐；19日上午，拜登在中国国家副主席习近平的陪同下出席了中美企业家座谈会……	抵达|观看	用餐	1
《华尔街日报》评论说，这是欧美主权债务问题和其他危机引发的担忧愈演愈烈并于上月底开始搅扰全球市场之后，世界最大的两个经济体之间的第一轮高层对话。	搅扰	对话	1
三天来，拜登在华的行程安排非常丰富：第一天抵达北京后以观看一场中美篮球友谊赛“轻松开场”；第二天忙里偷闲到北京小吃店用餐；19日上午，拜登在中国国家副主席习近平的陪同下出席了中美企业家座谈会……	抵达|观看	用餐	1
《华尔街日报》评论说，这是欧美主权债务问题和其他危机引发的担忧愈演愈烈并于上月底开始搅扰全球市场之后，世界最大的两个经济体之间的第一轮高层对话。	搅扰	对话	1
为保核工业，日本掩盖核辐射走向在日本福岛核危机发生后，日本政府没有在第一时间向附近灾民提供疏散指示，致使很多民众疏散的方向正好同风向一致，此外，在得知核辐射进一步的扩散走向后，日本政府再次选择沉默，也再一次将这些灾民置于危险之中。	提供	得知核辐射进一步的扩散走向后，日本政府次选择	1
英国媒体透露利反对派作战计划——先解放山区 再围攻首都英国《每日电讯报》发表文章，透露反对派进攻的黎波里的作战计划。	透露	围攻	1
美国和一些西方国家敦促卡扎菲立即下台据新华社电 在利比亚反对派武装推进到首都的黎波里之后，美国和一些西方国家先后表态，敦促利比亚领导人卡扎菲立即下台。	敦促|下台据新华社电在利比亚反对派武装推进|推进	表态|敦促利比亚领导人卡扎菲立即下台|下台	1
法国全国统计和经济研究所公布的数据显示，法国经济今年第一季度环比增长0.9%，但第二季度环比零增长。	增长	增长	1
他说，这群乘坐汽车和摩托车的武装分子先爆炸袭击了警察局，然后与警方发生了交火。	袭击	发生	1
除了租住的农庄估计每周需花费5万美元(约合人民币31.9万元)外，第一家庭更“前后脚”出发，分别乘坐军用飞机抵达度假地，再安排车队护送。	出发	乘坐|抵达|安排|护送	1
反对派计划先夺取苏尔特，然后攻占南部重镇塞卜哈。	夺取	攻占	1
飓风艾琳登陆美国东海岸已致至少14人死亡中新网8月29日电 综合报道，美东时间8月28日凌晨5点30分左右，历史罕见的飓风“艾琳”再次登陆美国东海岸，给美国第一大城市纽约带来狂风暴雨。	登陆	带来	1
宇航机构首先将在7日使主发动机喷射2秒后对其飞行姿势的偏差程度进行测量，然后于14日启动控制飞行姿势的副发动机，同时喷射主发动机20秒。	喷射2秒后对其飞行姿势的偏差程度进行测量|测量	启动	1
在鸣钟之前，他们将先默哀，然后由一位陆战队少校高唱《天佑美国》。	默哀	高唱	1
法国今年6月建议保加利亚和罗马尼亚加入申根区应分两步走，第一阶段是在今年秋季开放空中边界，并让其他国家的警察在机场口岸共同执法，第二阶段是在2012年开放陆地边界。	开放	执法|开放	1
然后经过九州西侧、冲绳本岛南部，从太平洋北上，于临近中午时分，在日本首相野田抵达福岛第一核电站视察的10时40分许，飞临福岛县近海空域。	经过	抵达|飞临	1
贾布里勒表示，目前利比亚解冻资金的移交行动已经开始，第一笔解冻资金由英国提供，金额超过十亿第纳尔(约8.7亿美元)，第二笔约7亿第纳尔也将于近日转交。	提供	转交	1
危地马拉总统选举进入第二轮投票新华网墨西哥城9月12日电 (记者陈寅) 危地马拉城消息：危地马拉最高选举法院12日揭晓总统选举计票结果，没有候选人在第一轮投票中获得超过50%的选票，爱国党候选人奥托·佩雷斯和议员曼努埃尔·巴尔迪松以领先票数进入第二轮投票。	获得	进入	1
报道称，赫克表示，由于朝鲜2006年进行的第一次核试验没有取得成功，因此在2009年进行了第二次核试验。	进行|取得	进行	1
据俄罗斯财务部消息人士透露，俄方减免朝鲜债务是出于以下几点考虑：第一，朝鲜没有偿还能力，而且除了俄罗斯，朝鲜还拖欠数十个国家的债务，规模达数十亿美元；第二，俄政府在推动经由朝鲜向韩国供应天然气和电力的项目，以及连接西伯利亚铁路(TSR)和朝鲜半岛铁路(TKR)的项目，而债务问题是一个绊脚石；第三，朝鲜自发偿还债务的可能性极低。	减免	拖欠	1
研究称海洋中泄漏福岛放射物将回流日本新华网东京9月14日电(记者蓝建中)日本气象研究所和电力中央研究所的联合研究小组14日说，福岛第一核电站事故后泄漏到海中的放射性铯－137，将乘着黑潮(日本暖流)向东扩散，然后沿顺时针在北太平洋循环，二三十年后又会回到日本沿海。	泄漏	循环	1
韩高官称若允许将考虑建第二个开城园区中新网9月14日电 据韩联社报道，韩国统一部长官提名人柳佑益14日表示，第一开城园区企业入驻完毕后，若条件允许，将考虑建立第二个开城园区。	入驻	建立	1
可以通过购买欧元区国债首先巩固自己在欧洲市场上的地位之后再解决自己的问题。	购买|巩固	解决	1
根据联合国规章，任何国家申请成为正式会员国，先得向联合国秘书长提出申请，由秘书长转交安理会，再由安理会向联合国大会推荐，最后在联大表决，获得现有全部会员国三分之二以上支持才能成为正式会员国。	提出	转交|推荐	1
始于8月11日的第一波强降雨主要对信德省的7个地区造成影响，但是第二波强降雨已经将影响范围扩大到包括卡拉奇等城市的整个信德省。	影响	扩大	1
每年一个地区的各个村庄均向地区管理办公室提出该村需要的项目申请，而该办公室则召开村落间会议，讨论项目可行性并确定应优先落实的项目，之后向村落拨款。	讨论|确定	拨款	1
日本核电站事故担当相细野豪志在会上发表了演讲，称“争取在年内完成”福岛第一核电站事故平息工作的关键阶段“冷停堆”，表示原定明年1月中旬实现的“第二阶段”目标将提前。	完成	实现|提前	1
日本核电站事故担当相细野豪志在会上发表了演讲，称“争取在年内完成”福岛第一核电站事故平息工作的关键阶段“冷停堆”，表示原定明年1月中旬实现的“第二阶段”目标将提前。	完成	实现|提前	1
美国地质勘探局称，美国东部时间19日下午2点，危地马拉先是发生了里氏4.8级地震，半小时后发生了第二次5.8级地震，随后又发生了2次规模较小的地震。	发生	发生	1
1.卫星现状●目前位于近地点195公里、远地点210公里的轨道上●1991年由“发现”号航天飞机送上太空●2005年退役，之后在地球引力作用下逐渐下降高度2.碎片分解●坠落时将分解为100多块碎片●可能落到地面的有害碎片数：26块●可能落到地面的有害碎片总重：532公斤3.坠地预测时间：23日地点：印度洋克罗泽群岛以北海域东经54度，南纬40度碎片散落区域的直径可达800余公里4.地面应对NASA发布提醒，看到落到地上的碎片时切勿触碰，应尽快报警先例回放“乱扔垃圾”NASA被罚400美元1979年7月11日，美国空间站“天空实验室”退役后坠入大气层。	下降	坠入	1
不过，先进细胞技术公司打算利用人类胚胎干细胞培育视网膜色素上皮细胞，随后将“新生”视网膜色素上皮细胞植入患者眼中，期望借助再生医学手段治疗这类眼疾。	利用|培育	植入|治疗	1
因此，在11月份接收来自宫古市的第一批1000吨地震废弃物之前，东京都将对这些废弃物的污染状况进行检测，然后在明年3月份之前对剩下的1万吨废弃物进行处理。	接收	检测|处理	1
依照规定，诺奖得主如果在评审委员会宣布获奖名单之后去世，奖项有效；在宣布名单之前去世，尚没有先例。	宣布|去世	宣布名单之前去世	1
之后德国火车公司要求员工对该地区加强警惕，火车总站附近隧道的爆炸物即为该公司员工首先发现的。	要求|加强	发现	1
据多伦多警方交通组表示，意外发生于10日清晨5时45分左右，当时一辆本田雅阁私家车，由一名华裔青年驾驶高速沿士嘉堡肯尼迪道北向南行，当车驶过一十字路口时突然失控，车先撞向左边路旁一个不到1米高消防栓、再直撞一根7米高的石头灯柱，由于撞力猛烈，该辆房车断成两截，车尾部分飞入油站的车道上，车头再飞起撞毁一个电话亭，再冲前十多米，最后停在油站旁一个小商场出入口车道上。	撞向|直撞	断成|飞入|撞毁	1
据他交代，自己是先在白天偷偷拧松了博物馆某个窗户的螺丝，深夜再回来作案的。	拧松	作案	1
据当地媒体报道，这一协议将分两个阶段执行：首先以方释放450名巴囚犯，哈马斯释放沙利特；两个月后，以方再释放577名巴囚犯。	释放	释放|释放	1
以巴什基尔共和国为例，生育第一个孩子时，青年家庭可获得价值8平方米住房的补贴；生育第二个孩子时，可获得价值12平方米住房的补贴。	生育	获得|生育	1
首先在反应堆建筑的外部建造钢铁架构，然后在钢架上铺设聚酯纤维。	建造	铺设	1
根据计划，美军将先派遣一个小分队部署到乌干达，接下来一个月内还将陆续增派人员，使美军总人数达100人，大多数为特种部队士兵。	派遣|部署	增派	1
首先是缉毒局发现美籍伊朗裔男子阿巴布希尔频频与他们安插在贩毒集团内部的线人联系，还进行了多次会面，然后财政部发现，阿巴布希尔通过秘密账户向那名线人支付了10万美元。	发现|联系	进行	1
因此，日本政府计划先试探中方的态度，然后在野田佳彦首相访华期间(预计为12月)与中国国家主席胡锦涛会谈时提出租借请求。	试探	访华期间(预计为12月)与中国国家主席胡锦涛会谈时提出|提出	1
根据竞选规则，由于无人在第一轮投票中获得绝对多数选票，得票最多的前两名候选人进入第二轮投票。	获得	进入	1
埃及将沙利特移交给以色列军方后，沙利特将首先与其家人取得联系，并接受以色列军方最高医疗人员的检查，然后回到距离特拉维夫不远的泰勒诺夫空军基地。	取得	接受|回到	1
欧元区国家领导人今年7月21日决定向希腊提供第二轮总额1090亿欧元的救援贷款，作为第一轮救援贷款的补充，同时要求希腊实施更为严厉的紧缩措施。	决定|提供	实施	1
相关链接“安迪利亚”蝉联亚洲豪宅第一第八届世界经理人峰会2011年9月28日在香港举行，当天晚间同时揭晓“亚洲十大超级豪宅”，印度首富价值10亿美元的摩天宫“安迪利亚”蝉联第一，中国南京的钟山高尔夫、中国香港的赫兰道11号分别占据第二、第三的位置。	蝉联	占据	1
但是卡梅伦担心，如果威廉王子和凯特王妃先生出女儿，以后再生出男孩，英国宪法将遇到危机。	生出	生出	1
第一枚炸弹爆炸数分钟后，救援人员和民众陆续聚集到爆炸现场，第二枚炸弹随即爆炸。	爆炸	聚集|爆炸	1
查尔斯王储拥有英联邦君主的第一顺位继承权，而安妮公主虽然年长于安德鲁王子和爱德华王子，享有的继承权次序却排在两个弟弟之后。	拥有	年长	1
小默多克再次就窃听丑闻接受英国议会质询  中新社伦敦11月10日电(记者 魏群)新闻国际集团总裁詹姆斯•默多克10日就前《世界新闻报》窃听丑闻再次接受英国议会质询，他重申事先不知道该报的窃听行为如此普遍，并称暗示其为“黑手党”是一种攻击。	接受	普遍	1
尽管杜伯曼本月4日以第一轮选举“充斥欺诈”为由宣布不参加总统选举的第二轮投票，但第二轮投票仍于8日如期举行。	宣布|参加	举行	1
第一道防火墙用来抵御欧洲主权债务危机的溢出效应，第二道防火墙则用来防止金融市场动荡影响到实体经济复苏。	抵御	影响	1
该方案分两部分执行：第一部分要求在十年内削减赤字9170亿美元，同时将公共债务上限提高9000亿美元，该项内容已经启动；第二部分是在国会成立一个削减赤字特别委员会(“超级委员会”)，由12名两党议员组成，负责在今年11月23日以前就下一步减赤额度和具体内容提出建议。	削减	提高|启动|成立	1
尤宾德拉先用原子笔挑起鞋底的线头，再用手指弄松线条，然后扯开鞋底，把里头的海洛因取出。	挑起	弄松	1
此外，还有两项风险将会凸显：第一，丑闻有可能改变新闻集团的结构；第二，英国有可能对新闻业进行过度监管。	凸显	改变	1
第一个风险只能留给法律和市场来决定，媒体应避免第二个风险的发生。	决定	避免	1
几个人离开，再次通过私人花园钻入诺塔巴图鲁事先停在那里的车子，一行人绝尘而去。	离开	钻入|而去	1
米歇尔陪同奥巴马抵达伦敦之后，首先前往唐宁街与英国首相布朗和夫人莎拉共进早餐。	陪同|抵达	共进	1
朝鲜第12届最高人民会议第一次会议当日在平壤举行，再次推举朝鲜最高领导人金正日为国防委员会委员长。	举行	推举	1
货车上至少有两人开枪，先打破了颂提汽车的轮胎，接着向车内密集扫射。	打破	扫射	1
而且，这种标签能跟踪和贮存它们在海洋中的深度、温度和光亮度，之后按照预先设定的日期让标签浮上水面。	跟踪|贮存	浮上	1
华盛顿地区地铁运营负责人约翰·卡托说，从目前的情况来看，当时第一列地铁列车正停在轨道上等待进站，而这时第二列列车突然从后面撞上第一辆列车。	停在	撞上	1
对于意大利总理贝卢斯科尼来说，近来一段时间似乎流年不利，先是与18岁美女模特的绯闻被曝炒，接着花钱嫖妓的丑闻被曝光。	曝炒	曝光	1
这个全长4分钟18秒的录像画面，哈德逊全裸走进房间，手持酒杯，之后穿上一件浴袍，和两名金发俄罗斯妓女畅饮香槟、接吻、交欢，他的面貌清晰可见，整个录像画面以“哈德逊先生的俄罗斯冒险”为名，被公布在当地的网站。	穿上	畅饮|公布	1
性爱录像曝光闪电辞职在这段时长4分18秒的视频中，赫德森走进叶卡捷琳堡一家声色场所，赫德森首先赤身裸体走进房间，接着录像带显示他披上了一件敞开的浴袍，一只手端着一只葡萄酒杯坐在沙发上喝酒，随后与两名只穿内衣的金发女郎亲吻。	走进	披上	1
从一名不识政治险恶的家庭主妇，成为凝聚在野阵营的核心人物，领导不流血革命成为亚洲第一位女性国家元首，之后又在七场军变的风暴中安然完成任期，被视为菲律宾民主象征的阿基诺夫人，以柔性力量写下传奇。	成为	完成	1
科拉松于1992年因宪法限制未再竞选连任，她所支持、时任国防部长的罗慕斯，以微弱票数领先接下了她的位子，继续解决她所留下来严重缺电、经济疲弱、土地改革未能贯彻、以及清剿叛军成效不佳等问题。	竞选	解决	1
揭秘奥巴马座驾：防护性能超过步兵战车(组图)美利坚合众国第44位总统奥巴马先生已于2009年11月15日来到中国，开始了他的访华之旅，这是他上任仅仅不到1年之后的首次访华之旅，除了与中国政府首脑会晤，他还将在中国体验中华民族的特有文化。	来到	开始	1
卡斯蒂莱斯供认说，他们先砍下受害者的头颅和四肢，去除内脏，然后把躯干挂起来用蜡烛烘烤，用桶接炼出来的油。	砍下	挂起来用蜡烛烘烤|烘烤	1
菲莉尔公主出生于1938年，是埃及末代法老法鲁克(曾在1936年至1952年统治埃及)和第一任妻子所生的大女儿，曾在瑞士一所私人寄宿学校求学，然后一直在那里居住直到去世。	统治	求学|居住	1
在这些暗杀行动中，频频出现摩萨特“女刺客”的身影，譬如一名摩萨德“美女刺客”就在塞浦路斯施展“美人计”，将一名暗杀目标引诱上了床，然后她假装离床前往卫生间，但却随后按下遥控按钮，引爆了事先藏在床垫中的炸弹，将那名堕入“美人计”的暗杀目标当场炸死在了床上。	离床前往|前往	按下|引爆|炸死	1
在这些暗杀行动中，频频出现摩萨特“女刺客”的身影，譬如一名摩萨德“美女刺客”就在塞浦路斯施展“美人计”，将一名暗杀目标引诱上了床，然后她假装离床前往卫生间，但却随后按下遥控按钮，引爆了事先藏在床垫中的炸弹，将那名堕入“美人计”的暗杀目标当场炸死在了床上。	离床前往|前往	按下|引爆|炸死	1
母象胖桐妈妈在1年多前怀孕，经过22个月的孕期，于前天凌晨1.09分产下第一头小象，接着在凌晨3点09分产下第二头小象，两头小象均为雄性。	产下	产下	1
在飞越科林斯运河前，麦迪逊先驾驶本田摩托车行驶了大约400米，绕过了一个池塘、一个足球场和一个养鸡场，最后他加速到了每小时125公里，然后飞速冲上斜坡，转眼间飞出悬崖，冲向运河上方的空中。	驾驶|行驶	绕过|冲上	1
当地时间23时30分左右，闻讯赶到的警方人士在警官奥马尔·卡卢亚纳的率领下先是再次按响门铃，在确认里面无人应答之后，众人继而用消防救护专用的液压剪刀剪断了皮卡耶夫公寓的门锁。	按响	应答	1
英国媒体评论说，王室成员投身慈善事业，一般选择先成为某个知名基金会的赞助人，然后才设立自己的基金会，因此哈里的举动非同寻常，此前有类似先例的恰好是哈里的母亲、已故的戴安娜王妃。	成为	设立	1
2008年7月，世界首位“怀孕男”比蒂就怀孕生下了他和妻子南茜的第一个孩子——现年两岁的女儿苏珊；从那以后，比蒂仿佛对怀孕上了瘾，他在去年6月再次怀孕生下了他们的第二个孩子——现年1岁的男婴奥斯汀；比蒂在去年年底通过人工授精第三次怀上身孕，今年7月25日，比蒂在俄勒冈州本德市的圣查尔斯医疗中心三度分娩，产下了他们的第3个孩子——一名健康可爱的男婴。	生下	生下	1
“第一是我完全猜对了他们当时的会话，当然这种可能性极小；第二是布莱尔认可我的创作并把它用到了自己的正式出版物中；第三就是布莱尔先生一时喝多了，混淆了电影与现实。”	猜对	认可	1
他先让潜艇在水下缓缓航行，然后使其上浮。	航行	上浮	1
1949年，与第一任妻子米尔德里德·威廉斯结婚，1959年离婚，育有两个孩子，现年58岁的克里斯蒂和55岁的大卫；1989年赫夫纳与第二任妻子金伯利·康拉德再婚，但双方去年分手，育有两个儿子，10岁的马斯顿和9岁的库珀。	结婚	离婚	1
英国东南部肯特郡4万只死蟹被冲上海岸(组图)环球时报特约记者宋华报道 据英国《每日邮报》1月5日报道，世界多地最近多次发生大量动物神秘死亡事件，首先是数千只燕八哥在美国阿肯色州坠亡，接下来又有数千条死鱼被冲上海岸。	坠亡	冲上	1
他强调，若要促成韩朝对话，朝鲜应先就“天安”舰事件和延坪岛炮击事件采取负责任的措施，承诺不再发起类似挑衅，对无核化表现出诚意。	采取	发起	1
2003年8月出任缅甸“和发委”第二秘书长，2004年10月升任“和发委”第一秘书长。	出任	升任	1
但是据外电报道，这位前世界第一的高尔夫球手因在迪拜沙漠精英赛最后一轮随地乱吐痰，再次陷入困境。	乱吐	陷入	1
一年后，这对夫妻带着孩子再次来到这里，并把儿子的第一双鞋子挂到树上以示纪念。	来到	挂到树上以示纪念	1
一年后，这对夫妻带着孩子再次来到这里，并把儿子的第一双鞋子挂到树上以示纪念。	来到	挂到树上以示纪念	1
2009年年底，默克尔再度当选总理，她抛弃了原先的盟友，与德国自民党一起组成了执政联盟。	当选	抛弃|组成	1
据德国《明镜》周刊报道，先是基民盟大佬、黑森州州长罗兰-科赫辞职，接着是总统霍斯特-克勒、汉堡市长冯·博伊斯特一一宣布辞职。	辞职	宣布	1
两年前，米尔斯第一次提出用螺丝钉在木板上钉画的想法，之后他屡次试验终于拿出了第一幅震撼人心的版画作品。	提出	拿出	1
警方相信，劫匪的如意算盘是，将珠宝先藏在隐蔽处，等警方追查的风头过去之后，再将它们取出伺机慢慢销赃。	藏在	过去	1
海地流行歌手以压倒性优势当选总统(组图)海地临时选举委员会4日公布总统选举第二轮投票初步计票结果，流行歌手米歇尔·马尔泰利以压倒性优势击败民主进步联盟候选人、前“第一夫人”米朗德·马尼加，赢得选举。	当选|公布	击败|赢得	1
丈夫成“碧粉”吃醋，严禁女儿追星早在2009年奥巴马刚上任之际，美国杂志便爆料，由于对奥巴马过分热情，碧昂斯曾遭到第一夫人米歇尔的私下警告，要求她检点一些，否则就不能再踏入白宫半步。	遭到	踏入	1
两年后的1998年，49岁的伊丽莎白再做产妇，先后生下一女一子。	再做|做	生下	1
挪威爆炸枪击案第一名遇害者下葬(组图)挪威警方昨日第二次讯问布雷维克检方正在寻找一切(指控罪名的)可行性对布雷维克进行指控。	下葬	寻找|进行|指控	1
25年来首度飓风侵袭、纽约史上第一次大撤离、生平第一次地铁与公交车全面停驶，再加上几天前发生的二次大战后第一个大地震，连一辈子住在纽约的62岁马雅都摇头说，“这不是我认识的纽约”。	侵袭|停驶	发生	1
这是自前首相菅直人在事故发生第二天的3月12日前往视察以来，第二次有首相亲自进入福岛第一核电站。	前往	进入	1
据悉，该长毛蚁可能率先从加勒比海岸一带登陆佛罗里达州，再依次进入亚拉巴马、密西西比、路易斯安那和德克萨斯等南部各州。	登陆	进入	1
火情就是命令，为尽快控制火势蔓延，现场指挥员立即下令，第一灭火小组利用消防车车载水炮打击火势，同时，在该建筑的东侧部署两辆高喷车举高射水，控制火势向四周蔓延；第二灭火小组组成两个内部攻坚小组深入火场内部灭火，同时搜救被困人员，疏散遇险群众；第三小组负责协助现场民警做好火场警戒任务，疏散围观群众，禁止一切无关人员进入火灾现场。	利用|打击	部署|控制|组成|灭火	1
王座正对着一座巨大的佛像，旺楚克先接过酒杯一饮而尽，然后给他的皇后加冕了一顶精美的织锦缎后冠。	接过	加冕	1
贾西姆说，一些身绑炸弹、发动恐怖袭击的女“人弹”，并非为了“圣战”而牺牲，而是掉进了她设的陷阱——她的同伙将事先选定的目标强奸，她再出面劝受害人以发动自杀式袭击的方式“洗清罪孽和耻辱”。	掉进	洗清	1
贾西姆说，一些身绑炸弹、发动恐怖袭击的女“人弹”，并非为了“圣战”而牺牲，而是掉进了她设的陷阱——她的同伙将事先选定的目标强奸，她再出面劝受害人以发动自杀式袭击的方式“洗清罪孽和耻辱”。	掉进	洗清	1
金正日妹夫张成泽被指未来朝鲜核心人物(图)他虽出身普通家庭但有留俄深造的经历和学识，与金正日唯一的亲妹妹金敬姬结为伉俪国际先驱导报特约撰稿于秋发自北京 4月9日，朝鲜领导人金正日再次被最高人民会议选为最高领导人。	结为	选为	1
她立即取消了一切既定安排，先与墨西哥卫生部长联系了解局势，然后前往美国卫生部与美国官员讨论疫病局势，随即从华盛顿向位于日内瓦的世卫组织总部人员下达了“总动员令”。	联系|了解	讨论	1
首先，大肆渲染巴核武库安全面临着巨大的风险，紧接着披露美军制定了接管巴核武库的作战计划，以试探国际社会和巴政府的反应。	渲染	制定|接管	1
朝鲜中央电视台播音员朝鲜中央通讯社周一发表以下有关朝鲜又一次成功进行地下核试验的报道朝鲜在2009年5月25日再次成功进行地下核试验加强了朝鲜自卫核威慑能力试验是应朝鲜科技人员的请求实施的25号的试验过后，朝中社的英文报道说，技术人员解决先前存在的一些问题，推进了爆炸当量和控制技术。	进行|进行|加强	解决|推进	1
这是2006年10月朝鲜第一次进行核试验，当时我做出一个预判，当时我也预见到，如果矛盾激化，朝鲜还可能进行第二次核试验，这是2006年的事情。	进行	做出|激化，朝鲜还可能进行|进行	1
李绍先：伊朗的选举之后出现动荡的局势由于好几次了，比如2005年，2008年，包括2005年拉夫桑亚妮败给内贾德的那一次大选，那么败选之后，曾经要求调查，而且出现了一定的示威。	出现	败给	1
张杨：我自己的看法是说，如果我们先假设他成功，如果他能举办也是时代的力量，也不是他个人或者我们具体做具体事的接纳公司也好或当时对应的团队也好的力量，事实上没有来，也不是因为我们或者只是说当时我们没有做好准备，两种文化，确实在93年有机会去拥抱，拥抱对方，然后融合，要比现在可能提前十年将近，但是不是一个城市跟一个顶尖的艺人擦肩而过，而是两种本来应该很早就融合在一起，拥抱在一起的文化擦肩而过了。	假设	举办也是时代的力量，也不是他个人或者我们具体做具体事的接纳|拥抱	1
您在第一时间得知这个消息之后你第一下反应是什么？	得知	第一下反应|反应	1
姜华：我们知道日本一直就想购买美国的F22战机，但是美国宣布F22战机停产之后，F35战机就成为日本的优先选择，陈老师，这种F35战机有什么特点？	宣布	成为	1
为保护通过索马里海域的日本船只不受海盗袭击，日本政府6号向索马里附近海域派出第二批自卫队舰队，以接替今年3月派遣的第一批舰队。	派出	接替	1
抵达训练营的第一天，这24名学员风尘仆仆从政府军车上爬下来，在他们眼前的正是接下来进行魔鬼训练的地方。	抵达	进行	1
日本准外相冈田克也：坚决反对台独被称媚中派日前，冈田提出了未来工作中的两条政治原则，第一，不参拜靖国神社，第二，不干涉中国内政 随着鸠山由纪夫即将就任日本新首相，冈田克也立时成为新内阁外相热门人选。	提出	参拜	1
尽管这些事给冈田带来了一些麻烦，但日前，冈田还是明确提出未来工作中的两条政治原则，第一，不参拜靖国神社，第二，不干涉中国内政。	提出	参拜	1
推荐《国际先驱导报》博客：http://blog.sina.com.cn/m/xqdb日前，冈田提出了未来工作中的两条政治原则，第一，不参拜靖国神社，第二，不干涉中国内政 随着鸠山由纪夫即将就任日本新首相，冈田克也立时成为新内阁外相热门人选。	提出	参拜	1
尽管这些事给冈田带来了一些麻烦，但日前，冈田还是明确提出未来工作中的两条政治原则，第一，不参拜靖国神社，第二，不干涉中国内政。	提出	参拜	1
另外两家获得政府救援最多的“大户”—— 以资产计算的美国第一大银行美国银行以及第三大银行花旗集团——第二季度双双实现盈利，且都好于市场预期。	获得	实现	1
当凯勒要搜索一个目标时，必须先联系一名当地的普什图人，再由这个普什图人前往指定的地点搜集情报。	联系	前往|搜集	1
最后，就把奥斯卡奖发给他了，他演过什么电影，他还没演呢，就说他老讲演电影的技巧，目前为止看到奥巴马他是一个明星，他讲很多政治理念，小布什对伊拉克发动战争，就说他有大规模杀伤武器，有核武器，就用这个办法发动，然后接下来还要对伊朗发动战争，伊朗现在搞核试验，结果奥巴马上来跟伊朗要和谈，在中东问题上到埃及发表一番热情洋溢的话，他都是，结果核问题上跟俄罗斯咱们俩先带头，这些都是很好的一些表示。	发动	发表	1
2009年6月12日，联合国安理会15个理事国一致通过了针对朝鲜第二次核试验的1874号制裁决议案，较之朝鲜第一次核爆后的联合国1718号决议更为严厉。	通过	严厉	1
但是我们现在先接进一个电话，我们现在电话联系一下我们中国的导演陆川，因为我相信陆导在听到这个消息之后对他可能会有一些启发，陆川你好。	接进	联系	1
因为，从东亚发展的历史中你会发现，先是日本和韩国发展，然后制造业转向东南亚，这些最初转移的基础制造业对创造就业岗位和有附加值产业非常重要。	发展	转向	1
主持人：接下来给您介绍另外一位嘉宾，是中国国际广播电台时事评论员洪琳先生，洪琳先生也曾经去过菲律宾那个地方，您如何评价这样的一起令人震惊的事件。	介绍	去	1
主持人：好的，谢谢庄先生从马尼拉给我们发回的报道，稍候我们再和您联系。	发回	联系	1
由于此次访问是在奥巴马总统刚刚结束亚洲之行之后进行的，且辛格是奥巴马就任总统后正式接待的第一位外国政要，因而备受关注。	结束|进行	接待|备受	1
他们先把船只改装成普通的大型帆船，然后驶出海岸线240公里海域，开始寻找可攻击的目标。	改装	驶出	1
两派议员先是跳到桌子上相互怒吼，接下来又相互泼水，最后发生短暂斗殴，造成一些议员受伤。	跳到|怒吼	泼水	1
然而，为有效履行美国对包括日本在内的远东国家的国防应承担的国际义务，在重大紧急状况发生时，在与日本进行事先协商后，美国政府将要求将核武再度携入冲绳，并且获得通过冲绳的权利。	进行	要求|携入	1
1928年11月，斯大林接见瞿秋白和张国焘时，眉飞色舞地讲述他如何在32岁才得到《资本论》第一册，并在警察环伺的境况下偷读了那本圣书，接着花了好几年时间熟读马恩著作，才懂得一点马克思主义。	得到	偷读|熟读	1
医改法案让美国医保覆盖面提高到95%众议院当天就医改法案的投票分为两个部分，首先以219票赞成、212票反对的票数通过了法案的核心部分，即参议院去年12月通过的医改法案；在随后的再次投票中，以220对211的票数通过了医改“预算和解”法案，即众议院民主党人针对参议院法案提出的修改议案。	通过	通过	1
在该法案生效后的第一个10年内有望使政府预算赤字减少约1380亿美元，在第二个10年内减少约1.2万亿美元。	生效|减少	减少	1
《时代周刊》预测未来 凸显“美国中心论”水均益：这个话题，我们接下来还请来了另外一位嘉宾，这就是环球网评论频道的主编雷志华先生，跟高先生，我们一块来梳理一下《时代周刊》所谓未来10年的预测。	请来	梳理	1
出门乘坐“大水牛”在伊拉克和阿富汗，美军拆弹部队的主要任务有三个：第一是保护重要人物的交通安全，第二是拆除已发现的简易爆炸装置，第三是在爆炸发生后前往爆炸现场调查，寻找线索等。	保护	拆除	1
如何排弹：先设防护圈 再定拆不拆遇到以上两种情况，根据标准程序，美军通常先设立防护圈，然后拆弹专家进入场地。	设立	进入	1
那年8月29日凌晨4时，苏联第一颗原子弹“铁克瓦”试爆成功，自此，苏联打破了美国的核垄断，成为世界上第二个拥有可用于实战的原子弹的国家。	试爆	打破|成为	1
在“末日地堡计划”被披露之后，维西诺最近实地走访加州沙漠一处“未经披露的地点”，视察该地堡计划的第一个成品。	披露	走访|视察	1
据往年的经验来说，可能第一个选区公布结果，可能也就是在投票站关闭一个小时之后，也就是说在当地时间晚上11点的时候，我们就能知道谁第一个当选了下一届英国国会的议员。	公布	关闭	1
首先是4月15号三大党首首次当着电视机的千万观众同台辩论，自民党党首克莱格凭借良好的表现一举成名，人气飙升，自民党的命运由此发生了转折，排名上升到第二名。	同台|辩论	飙升|上升	1
先是党内同僚倒戈，呼吁工党进行投票，试图将布朗赶下工党党首的位置，然后是记者出书，揭露布朗性格暴躁，对手下拳打脚踢，出言谩骂。	倒戈	进行	1
卡梅伦大学毕业后，先是进入保守党政策研究部门任职，又在某商业电台工作7年之后，才最终从政。	进入	工作	1
法国媒体报道称，他在还没跟第一任妻子居里奥利离婚时，就与第二任妻子赛西莉亚相恋。	离婚	相恋	1
在这个期间，双方交火是随时都有可能发生的，所以在大使馆以及当地红十字会的帮助下，我们首先是搭乘摩的撤离了红衫军的区域，之后又搭乘了救护车，离开军队把守的区域，最终现在是来到距离核心示威区大概一公里左右的一家酒店里持续来工作。	撤离	搭乘	1
我们接下来来看一下以色列军方今天公布的一段画面，这个画面是从直升飞机上面拍到的，我们请我们的特约评论员宋晓军先生和周庆安先生一起来看着画面，帮我们解读一下。	公布	拍到|解读	1
他通常先“偷偷摸摸地”在场外观看，然后突然会跳出来督导他们更努力些，或者直接给他们指导些要领。	观看	跳出来督导|督导	1
从世界上其他地方的电视机里，几乎所有熟悉足球的观众都会发现奇怪之处：第一，朝鲜队整场放弃赖以自保的防守战术，改与强大的葡萄牙对攻；第二，主教练布置的对攻阵型却是老一套的541，绝大部分时间只有他们的明星球员郑大世一人在前场孤独地奔跑和匆忙地射门。	发现	放弃|对攻	1
他们行动有计划，过程有指挥，海盗上船抢劫前，均事先摸清被劫船舶的船上设备、航线、船员人数等全面资料，再进行抢劫。	摸清	进行	1
实际上联合灭火方法最有效，先由轰炸机(投掷灭火炸弹)压制火势，然后由伊尔-76运输机和别-200两栖飞机掠地飞行喷水灭火，最后由米-26、米-8和卡-32P直升机大量喷水彻底扑灭火源。	投掷|压制	灭火	1
就西欧各国的情况看，废除死刑首先是减少在法律上判死刑的罪名，然后引入替代刑或减刑以求在事实上废除死刑，最后在法律上废除死刑。	废除|减少	引入|废除	1
对此，柳明桓再一次扮演了协调者的角色：先迅速回应，警告朝鲜谈判可能陷于崩溃；然后立即赶赴美国与美官员协商；回国后表示，韩国政府对朝核问题出现的困难局面将保持耐心，说服朝鲜继续对核设施进行去功能化。	回应	警告|陷于|赶赴	1
想请教一下高先生，再给我们简单来说一说以前民主党党代表的选举一般通过什么样的方式进行的，怎么决定人选的？	请教	进行	1
比如说菅是第二次担任当代表，第一次事实上是各方势力已经达到了一个妥协方案，最后推出了一个人，这个人距离党的核心人物是很远的，让他出来做一个陪衬，当时是一个“无风选举”。	担任	达到|推出	1
这种思想是不对的，然后他也是比较了中国和印度，他说为什么中国和印度正在赶上美国，不是靠廉价的劳动力和低汇率是因为它现在和我们一样拥有自由的市场、先进的教育、充足的资金和技术。	比较	赶上|拥有	1
11年来，该项目的第一个目标已经实现——分布式计算概念的可行性及实用性得到了充分证明；然而，项目的第二个目标——搜寻地外文明信号却始终未果。	实现	搜寻	1
专家观点：电信公司“一键通”图快更图财另外一部分其实是它公司手机的问题，它的手机可以一键上网，但问题是它一键上网图的不是快，它图的是你的钱，因为只要你摁了，它就自动登录网页，然后它就开始计费，所以另一部分它真正赔款的人是那些一看自己上网马上就把手机要摁掉的这些人，他等于没有浏览，没有享受服务，韦里孙公司就是以你已经登录为由，我来收钱，这件事情被FCC，也就是美国的联邦通信委员会认为这是不合法的，所以要求他改正，这两件事都是有短处，但这个短处都不是特别严重，所以他要抢在前面，先止损，用9000万美元把这个事情了掉。	计费	享受|要求他改正|改正|了掉	1
劳春燕：我们也一起来看一下美国舆论和媒体一些评论，美国联邦通讯委员会执法局的局长米歇尔·埃里森，他说我们很高兴看见韦里孙公司终于回报了用户，但是问题还是存在的，赔偿消费者仅仅是第一步，下一步是如何来保证这样的事情不再发生了？	赔偿	发生	1
根据那个时候的《国际法》，发现即先占，这是当时的《国际法》原则，中国是发现先占了钓鱼岛，取得了主权，接下来中国人民在那航海、捕鱼、采集、避风，甚至有渔民在那季节性的居住，通过这种方式进一步开发利用钓鱼岛，并且在明朝的时候就把它列入我们海防的防区，就说明当时的政府行使了管辖权。	发现	取得	1
但问题是：不可能是他先制作证明，然后村木再发出命令的吧？	制作	发出	1
 不过，再怎么减薪，公务员仍然是金融危机期间各国职场新人的第一选择。	减薪	选择	1
17日下午，又有一批右翼分子进行反华示威，先在东京秋叶原公园集合，然后在附近主要街道游行，并前往中国驻日本大使馆外，游行进行了一个多小时。	集合	游行	1
列维在评论中称，奥巴马执政团队先是傲慢地抛弃此前的协定，然后又高调宣称奥巴马此次亚洲之行将达成新的协定，最后的结果却是美国经历两年的讨价还价，仍然未能与韩国就此问题达成任何协定。	抛弃	达成	1
俄百年军舰阿芙乐尔号退役掀去苏联化争论俄“去苏联化”风波再起军舰退役之争，表面上只是在争论这艘百年巨舰是否具有军事地位，背后却反映了俄罗斯“去苏联化”的过程《国际先驱导报》特约撰稿姚望、费佳发自莫斯科、圣彼得堡 “救救阿芙乐尔！”	退役	争论	1
在12月7日官方公布的第一轮选举结果中，前第一夫人、法学教授米兰蒂·毛尼加蒂以31%的得票率拔得头筹，执政党候选人塞莱斯廷得到22%的选票位列第二，按照规定，这两人将进入1月16日的第二轮大选。	拔得	得到	1
EveryDNS拒绝解析维基解密域名之后仅仅2小时，瑞士海盗党第一时间提供了新域名帮助；瑞典的无政府主义者则租了一个山洞军事掩体，帮维基解密重新架设了服务器。	解析	提供	1
全民医保新模式解码孔保罗笔者所说的社会全面医疗援助保障，是根据各取所需各尽所能援助提出的一种社会医疗保障模式，其原则性基本要点如下：社会医疗保障体系为每个当前无力承担自己的医疗费用的社会成员，支付其所需要的正常合理的医疗费用，确保每个人都可以获得正常合理的医疗服务；当上述人士产生还款能力之后，连同利息一起，像纳税一样按照其可纳税收入的比例，逐步而直接地偿还给医疗保障体系，直到全部还清为止；但收入低于纳税标准，则无需偿还任何费用(即使收入高于纳税标准，也无需将全部可纳税收入用于偿还医疗费用，而是按照一定的比例，逐步偿还，以确保其维持正常的生活标准)；如果一个人的正常合理的医疗费用非常高，而其收入则有限，则仅需要承担其部分医疗费用，而无需承担全部费用，以确保其正常的生活水平不会降低；如果一个人过世，其医疗费用尚未还清，其遗产应该首先用于偿还其尚未还清的医疗费用，结余部分再由法定继承人继承；如果一个人的未来收入(包括遗产)也不足以抵偿其正常合理的医疗费用，或用于正常合理的医疗费用会影响其正常的生活标准，则由社会医疗保障体系承担全部责任；减免低收入及中产阶级纳税人的社会医疗保障税费(包括直接的和间接的两种)；富人仅需要以纳税的方式承担自己和永久性低收入与无收入人士的医疗费用责任，而无需再承担当前及未来的中产阶级与富人的医疗费用责任。	偿还	继承	1
但顺风顺水的日子不可能长久维持，泡沫经济破灭之后，政府减少了对房地产项目的公共投入，这自然使得原先的大饼大幅缩小。	破灭	减少|缩小	1
先是时隔44年的劳动党代表会议于9月28日召开，选出了新一届国家最高领导机构；接着是10月10日又迎来劳动党建党65周年，“整个朝鲜都处于欢庆的气氛中，也处于国际社会的高度关注之中”。	召开	选出|迎来	1
美国第二轮量化宽松货币政策为什么会受到那么大的批评，我想最主要的一个原因是现在实行第二轮量化宽松和在实行第一轮量化宽松的时候背景存在很大的差异。	受到	实行	1
9月23日，微博拍卖为海地开展救援工作在高调的募捐活动之后，当红影星艾娃•朗格利亚发起了世界上第一个微博拍卖，用以支持海地救灾工作的继续进行。	开展	发起|支持	1
从上个世纪70年代以来，第一次爆发在美元贬值的时候，石油就开始涨价，然后每一次美国超发货币的时候，石油就开始涨价，70年代如此，21世纪初也是如此。	贬值	涨价，每一次美国超发|超发	1
实际上，这也能倒逼我们再进入新能源的时代，现在很多中国企业在新能源方面占领了一定的先机，那么在这个时候把握住机会，可能会有一个质的飞跃。	进入	占领	1
他们的讲述和2月23日，记者在埃及港口城市亚历山大遇到的第一批从陆路撤离到埃及的中国工人的讲述有着相似之处：蒙面歹徒们带着武器前来洗劫营地，搬走了办公室里的电脑、复印机、家具，开走了工地上的叉车铲车，然后一把火把营地烧光……	遇到的批从陆路撤离到埃及的中国工人的讲述有着相似之处：蒙面歹徒们带着武器前来|带着武器前来|前来	开走了工地上的叉车铲车，一把火把营地烧光|烧光	1
入殓师会先摘下口罩，给死者行一下礼，然后开始清洗遗体：脱掉原来满是泥土的衣服，把身体冲洗干净，再穿上跟中国民间风格类似的送葬服，然后放上黄色或者白色的菊花。	摘下	清洗	1
截至4月4日，22个阿拉伯国家几乎全部相继发生不同程度的下争民权、上反集权，既要饭碗，更要尊严的群众和政治派别运动：——也门，总统萨利赫一退再退，先宣布2013年任满不再连任，也不传位给儿子，但反对派坚持其立即下台；后宣布改变政体结构和国家制度并启动权力移交程序，反对派依然不干；再宣布成立过渡政府年底前大选辞职，对手依然不干，而且军队出现分裂和对峙……	宣布	坚持|宣布|改变|启动|成立	1
第一阶段主要用于“切实减少核辐射量”，第二阶段主要工作内容为“控制放射性物质的扩散，大幅降低辐射量”。	减少	控制	1
卡扎菲打破这个僵局先出了一张牌，也就是他从米苏拉塔撤了军，然后达成了跟米苏拉塔部族的交易，因为这个地方有两个大钢厂，还有大量的未来开发的商业区，那么当地地头的部族受理，我交给你们，你们去跟反对派玩儿。	打破	达成	1
正在评论：“捕食者”“死神”充当战场第一配角专家观点：  死神将在东亚主要执行侦查监视任务捕食者可进行区域控制和定点清除尹卓：当然在巴基斯坦主要实施的一个是监视，一个是打击，它当时是跟“全球鹰”配合的，“全球鹰”进行大范围地侦查，然后发现具体目标以后，有可能要详查，加上打击的，它把捕食者招来，捕食者进行区域控制，它是大范围地控制，然后这样引导双方配合作战。	充当|执行|实施	进行|发现	1
据说到2025年，美军90%的战机就可能是无人机，有这个说法，到2050年，美军就不再装备有人驾驶的飞机，而是清一色的无人机，这个话题我们先不说，但是我很关心的还是今天大家很关注的，坊间也比较关注的热题，用无人机来监视中国，监视中国什么？	装备	监视	1
更让外界担心的是，美国目前对叙利亚采取的措施，与此前对利比亚的手段如出一辙：先指责当地政府“镇压民众”，随后宣布对其实施制裁，紧接着游说欧洲甚至联合国对其实施制裁，最后很可能以“人道主义”名义动用武力进行直接的军事干涉。	指责|镇压	宣布|游说	1
2002年，英国第一季度GDP增长了0.8%，第三季度增长了0.7%，而女王登基五十年庆的第二季度仅增长了0.4%。	增长	增长|增长	1
但好景不长，在保持了还不到一个月的短暂稳定之后，俄汽油价格在4月的第一周又恢复了上涨，涨幅为0.46%。	保持	恢复	1
今天还有一个信息，宋先生分析一下，刚才我们短片也提到了，实际上锁定拉登是有点撞大运，因为在审讯关塔那摩的犯人当中，无意当中听到一个名字是个代号，然后再进一步审讯，又听到这个名字。	分析	审讯	1
今天还有一个信息，宋先生分析一下，刚才我们短片也提到了，实际上锁定拉登是有点撞大运，因为在审讯关塔那摩的犯人当中，无意当中听到一个名字是个代号，然后再进一步审讯，又听到这个名字。	分析	审讯	1
从产品设计到营销阶段，企业均先考虑这些消费特点，再推出商品。	考虑	推出	1
第四代武器，第二代的素质无论是西北岛屿防卫司令部的成立，还是“先斩后奏”方针的确立，都是韩军在“天安舰”和延坪岛事件后总结经验教训并进行国防改革的一部分。	成立	进行	1
这样一个主张和日本以及中国的主张又有什么样的冲突，中日在东海划界和油气开发的问题上，其实本就存在着争议，那么现在韩国又要加进来，东海问题会否会成为第二个南海像这样的复杂化的趋势，今天我们要来关注这方面的话题，演播室来请来两位嘉宾，先给大家做一个介绍。	成为	关注|请来	1
 张召忠：对，它先挂了一个号，要求5月13日之前，5月13号之后就等于你放弃这个权利，就说有能力的像越南、菲律宾当时请了很多外国人，像英国的、外国的帮它去勘探，准备英文材料，好正儿八经提了，日本也提了。	挂了	放弃	1
孙哲：因为卡塔尔，你看第一次协调会议是在卡塔尔召开的，它出钱出力，然后请别的国家去商量政治解决方案，这种情况下，卡塔尔它自己非常不满足于自己自给自足的这种富裕的生活，很想在中东地区扮演一个……	召开	商量	1
劳春燕：有这样的一个背景在里边，现在利比亚战场上真真假假的消息特别多，我们也知道卡扎菲的第六个儿子哈米斯，前不久又传出他死亡的消息，哈米斯已经第二次被死亡了，这次不知道是真是假，尹先生给我们判断一下。	死亡	判断	1
第一它在大量地种植，第二个在阿拉伯分支这块它在制造这样的东西，有些个小作坊在制造这个东西，再加上也门，像津吉巴尔那个地方，津吉巴尔从5月份被占领之后，宣布成立伊斯兰酋长国，到现在都没收拾下来，现在还占着。	种植	制造	1
美国前总统布什回忆9-11曾力排众议回华盛顿中新社纽约8月29日电(中新社记者 孙宇挺)“第一架飞机撞上世贸中心大楼的时候，我以为是个事故，第二架飞机撞向世贸大楼的时候，我意识到美国遭到攻击了，第三架飞机撞上五角大楼的时候，那是向我们宣战了。”	回忆9-11曾力排众议回华盛顿中新社纽约8月29日电(中新社记者孙宇挺)“架飞机撞上|撞上	撞向	1
8月29日，民主党选举中第一轮投票，5名候选人都没有获得半数，第二轮投票在获选票最多的第一名海江田万里与第二名野田佳彦之间进行，投票前有15分钟的演讲机会。	选举	获得|进行	1
为应对阿富汗日趋恶化的局势，奥巴马的第一个重大军事决定就是向阿富汗增兵1.7万，随后他宣布再增兵4000。	增兵	宣布	1
民主党人对奥巴马的失望，首先是在处理国家安全问题上，奥巴马上台后很大程度上沿袭了小布什时期的一些政策，随后在推行医保改革时轻易放弃左派民主党人强烈支持的“公共选择”内容，继而又增兵阿富汗，再后来延长布什的减税政策。	处理	上台后很大程度上沿袭|沿袭|推行|放弃|增兵|延长	1
正是在这里，乔布斯七岁时在父亲的车库里有了自己的小工作间，学习拆开东西再重新组合；也正是在这里，他在邻居的推荐下参加了惠普公司的“发现者俱乐部”，并在惠普公司的餐厅聚会中，第一次见到了电脑；还是在这里，上初中的他认识了年长他5岁的沃兹，这个与他在8年后一起创立苹果电脑公司的人……	重新组合|组合	参加|见到	1
群众运动会闹大有几个条件，第一，看有没有重大的社会力量介入；第二个，看高层政治家操不操纵；第三个，有没有意外事件发生。	闹大	介入	1
但是战争初期它是靠大量的空中轰炸，但是它有一个，抓到一个点就是要用利比亚人打利比亚人，或者今后比如伊朗人打伊朗人，或者是叙利亚人打叙利亚人，它必须要找到一个足够强大的反对派，而这个反对派事先你要把它武装起来，要把它发动起来，动员起来，让它今后有足够的政治上的动因让它推翻现政权，然后你用空中打击的办法，北约和美国不直接参战，它用远程精确打击，非接触作战的方法去解决这个国家，这种国家作为一个局部战争的样式，这个要复制起来是相当困难，因为你要找到这样的利比亚一样的国家，这个国家又有足够强大的反对派，这个反对派又有足够的军事能力去推翻它，那这时候在你的援助下，可能能达成目标。	武装	发动|动员起来，让它今后有足够的政治上的动因让它推翻|推翻	1
他强调，随着中国科学家获得更先进的研究结果，他们将不再需要俄罗斯同仁的经验。	获得	需要	1
数字人民币将首先在小范围进行测试，之后进行大范围推广。	进行	进行	1
韩国东亚杯上首先以2比0战胜中国香港队，此次胜出中国，但因净胜球不及日本，积分排行第二。	战胜	胜出	1
韩联社首尔3月24日电韩国总统文在寅24日主持召开第二次紧急经济会议时表示，会议决定扩大第一次会议上敲定的50万亿韩元金融救济措施的规模，将投入100万亿韩元（约合人民币5655亿元）帮助企业应对疫情带来的冲击。	主持召开|召开	决定|扩大|敲定|投入|帮助|应对	1
起亚汽车去年第一季度首次在海外推出秀儿电动版，现代汽车第二季度开始出口KONA混动版。	推出	出口	1
©REUTERS/POOL中国商务部：中美经贸团队正就第一阶段协议有关后续工作密切沟通协议正式签署后将对外公布据路透社援引姆努钦的话报道：“现在正在解决技术性问题，协议还需要再翻译。	解决	翻译	1
我的方法是先跟孩子商量，征求她的同意，然后带孩子去体验，再和她沟通体验的感受，最后让她自己做出选择，但是一旦选择，就不能轻易放弃。”	商量	征求	1
首先，中美两国意识到持续的中美贸易战导致双边贸易急剧下降，明年上半年签署第一阶段的贸易协议后，将就国企改革、产业补贴等结构性问题开展第二阶段谈判。	签署	开展	1
相反，两国在签署第一阶段贸易协议后再次出现分歧，矛盾或因此激化；或者早期签署第一阶段协定签署后，双方在短时间内就结构性问题达成一揽子协议。	签署	出现	1
此次是文在寅就任后第三次实行特赦，第一次于2017年12月特赦6444人，第二次于2018年2月特赦4378人。	特赦	特赦	1
值得一提的是，这是文在寅就任后第三次实行特赦，第一次于2017年12月特赦6444人，第二次于2018年2月特赦4378人。	特赦	特赦	1
第一次韩中日教部部长会议2016年在韩国举行，第二次会议2018年在日本举行。	举行	举行	1
©REUTERS/MikeBlake专家：中美第一阶段贸易协议近期恐难签署发言人在谈到美国总统特朗普表示他并不介意等到明年美国进行选举之后才去签署中美之间的贸易协定的表态时说，“大家可以一起来回忆一下，自从去年3月份中美贸易摩擦发生以来，中方有没有对外去讲，我设定想什么时候达成协议，有说过吗？	签署|谈到美国总统特朗普表示他并不介意等到明年美国进行|进行	签署	1
他们在机场外接受中方第一轮测温，进入航站楼值机后接受中方第二轮测温，通过安检后又接受韩方检疫，只有无症状人员登机。	接受	进入|接受	1
前一晚，首批撤离人员被要求截至9点到武汉机场集合，他们在机场外接受中方第一轮测温，进入航站楼值机后接受中方第二轮测温，通过安检后又接受韩方检疫，只有无症状人员登机。	接受	进入|接受	1
易斯达航空先决定停飞7条中国大陆航线，后于3日再决定停飞仁川至香港、仁川至澳门、济州至澳门航线。	停飞	决定|停飞	1
韩联社首尔3月24日电韩国总统文在寅24日主持召开第二次紧急经济会议时表示，会上决定扩大第一次会议上敲定的50万亿韩元金融救济措施的规模，将投入100万亿韩元（约合人民币5655亿元）帮助企业应对疫情带来的冲击。	主持召开|召开	决定|扩大|敲定|投入|帮助|应对	1
▲韩国将投入5600亿元支持企业应对疫情冲击韩国总统文在寅24日主持召开第二次紧急经济会议时表示，会上决定扩大第一次会议上敲定的50万亿韩元金融救济措施的规模，将投入100万亿韩元（约合人民币5655亿元）帮助企业应对疫情带来的冲击。	投入|主持召开|召开	决定|扩大|敲定|投入|帮助|应对	1
这是日本防卫相第二次下达“破坏措施命令”,第一次发布命令是针对朝鲜2009年发射经过日本东北部上空的导弹一事。	下达	发射	1
2月12日，舞水端里附近的车辆进入仓库，被认为是工作人员正在进行“大浦洞－2”的第一级、第二级燃料的装配工作。	进行	装配	1
而“5027作战计划”则强调：若朝鲜“南侵”，美韩联军先退至一定地点，待集中兵力后再发起反击。	退至	集中|发起	1
还有驻防涟川中部的韩国陆军第5师“钥匙部队”，寓意能“打开统一之门”；驻防江原道西部地区的韩国陆军第6师“蓝星部队”，该部曾打到过鸭绿江，时至今日又提出“再饮鸭绿江水”的狂妄口号；驻防江原道铁原的韩国陆军第3师“白骨部队”，他们曾是当年第一支越过“三八线”的韩国部队。	提出	支越	1
今年空演期间，韩美两军将先各自演习，再联合进行营级演习，利用韩军和驻韩美军的指挥系统共享训练情况，重点提升两军的互操作能力。	演习	进行	1
这种武器包括两级：第一级为助推火箭，将其加速到超音速，然后第二级的空气动力弹头与助推器分开，并滑翔攻击目标。	助推	加速|分开	1
显摆一番美海军库克号宙斯盾驱逐舰驶离黑海或又是一事无成,日前美国海军唐纳德库克号宙斯盾导弹驱逐舰离开黑海海域进入了博斯普鲁斯海峡，这是美国在乌克兰和俄罗斯在刻赤海峡冲突之后派遣的第一艘驱逐舰在黑海的行动的结束。	离开|进入	派遣	1
同时，重启开城工业园区还没有进入实质性阶段，韩方可能是希望先观察开城工业园区的状态，视情况再讨论金刚山旅游的问题。	观察	讨论	1
韩军和政府相关人士28日透露，韩美正在考虑如下两种方案：第一，美国将在半岛循环部署F-22、F-35B战机;第二，向半岛定期出动B-1B轰炸机、核动力航母，并增加其出动次数。	考虑	部署	1
该发言人称，在年底期限即将到来之际，美方对朝挑衅不断升级，先是国务卿蓬佩奥要求各国彻底履行联合国对朝制裁决议，之后又要求召开安理会讨论朝鲜问题，再一次拿我们的自卫性武装现代化措施说事，发起敌对挑衅行为。	要求|履行	召开|讨论	1
该发言人称，在年底期限即将到来之际，美方对朝挑衅不断升级，先是国务卿蓬佩奥要求各国彻底履行联合国对朝制裁决议，之后又要求召开安理会讨论朝鲜问题，再一次拿我们的自卫性武装现代化措施说事，发起敌对挑衅行为。	要求|履行	召开|讨论	1
值得一提的是，这是文在寅就任后第三次实行特赦，第一次于2017年12月特赦6444人，第二次于2018年2月特赦4378人。	特赦	特赦	1
王毅在布鲁塞尔表示，“中国在磋商时总是指出两个要素：第一是中美贸易联系应当遵守世贸组织规则；第二是两国应当遵守市场规则。”	遵守	遵守	1
而社保费认真追缴的话，不排除一些企业选择先停业，重新申请工商执照后再开业，以逃避历史欠账。	选择|停业	重新申请|申请|开业	1
他介绍说，如果媒体记者要旁听必须预先到宣传部门进行资格审查，主要审查提出申请的媒体是否属于正规媒体，然后宣传部门再根据审查情况给予择优批准。	旁听	提出|批准	1
北京市农业局重大疫情办相关负责人援引专家的话说，从国外的案例来看，美国、加拿大、比利时等国家都先后检出人感染病毒后再传染给动物的情况。	后检	传染	1
他打起了主意，先将自己衣服脱光，只剩一条内裤，然后爬到了隔壁阳台上。	脱光	爬到	1
江苏2056万大奖得主领奖用支票挡脸(图)就在人们纷纷猜测7月23日晚开奖的超级大乐透08085期2056万得主究竟为何方神圣之际，昨天中午，大奖得主江苏无锡的吴先生夫妇已神秘现身位于南京市广州路的省体彩中心兑奖大厅，在办理好兑奖之后迅速离去。	现身	办理|离去	1
每次作案时，先由一名年轻女孩扮成普通顾客进入银行，然后女孩抽出枪，迫使银行职员打开安全门，团伙其他蒙面成员鱼贯而入。	扮成|进入	抽出	1
漏网之蛇更猛更大据李氏姐妹介绍，警察赶来后先抓住了浴室外那条蛇，之后又在厨房的柜子底下抓出另外4条。	赶来后抓住|抓住	抓出	1
他们找来一只猴子的尸体，先用剪刀剪掉了它的尾巴，然后用毛发去除剂除去了它全身的毛发，最后他们往死猴子的尸体上涂上了一些绿颜料，转眼间，这只死猴子就变成了一个模样怪异的“小绿人”。	剪掉	除去	1
他们找来一只猴子的尸体，先用剪刀剪掉了它的尾巴，然后用毛发去除剂除去了它全身的毛发，最后他们往死猴子的尸体上涂上了一些绿颜料，转眼间，这只死猴子就变成了一个模样怪异的“小绿人”。	剪掉	除去	1
原来，2006年12月22日套用颜先生车牌的一部车在湖北省黄梅县濯港镇出事故后，当地交管五大队第二中队警员发现驾驶员跟车主不是同一人时，通过内部交警网络系统第一时间就查到颜先生的手机，并打电话核实。	套用	发现	1
一旦有化学性药水误入眼睛的事情发生，在家应先用大量的清水冲洗15—20分钟，再及时送到专业的眼科医院进行治疗，争取最好的治疗效果。	冲洗	送到专业的眼科医院进行|治疗	1
储户存万元现金要求每次存10元本报讯（见习记者 成熔兴 实习生 包洎源 毛璐）在银行汇款却与柜员怄气，先是要求取出1000张10元纸币，之后又叫来朋友开个账户再将钱存入。	取出	叫来|存入	1
递上银行卡之后，柜员称电汇需填好电汇单之后才能办理，因此将左先生的卡还给了他。	填好|办理	还给	1
柜员再三向他说明先要排队，左先生就是不依，称自己有急事，柜员这才破例给他办理。	说明	办理	1
陈先生说，因为该银行当时已经下班，且周末不上班，如果报警陈先生又担心会给自己带来麻烦，“担心到时候说不清楚，要成了个许霆第二怎么办？”	报警	说不	1
陈先生决定先替失主保管这笔钱和银行卡，第二天再向报社求助。	保管	求助	1
于是，这名生意人煞费苦心，策划、导演了一场英雄相救的现场：先找人刺伤董事长，他自己再出面相救，不料事情最终败露。	刺伤	相救	1
赖琴答应帮忙介绍雷先生给他认识，周小平却担心雷先生不帮他，于是便策划了制造遇刺事件、再假装偶遇仗义相救的办法。	担心	策划|制造	1
陈刚认为，被辞退的员工要取得有利于自己的证据，首先是证明签订劳动合同的时候，自己并没有到场，其次是自己获得劳动合同是在被工厂辞退之后。	签订	到场，其次是自己获得|获得	1
我们可以先像朋友一样相处，然后看看会不会爱上彼此，是否适合共同生活。”	相处	爱上	1
当事者可先向法院起诉，然后到指定的专业司法鉴定中心进行鉴定，但因收集证据很难，索赔难度很大。	起诉	指定|鉴定	1
两嫌疑人作案方式是事先踩点摸清逃跑线路，然后盘踞在小巷口“等候”并抢夺过往女士戴着的金项链等财物。	作案|摸清	抢夺	1
她先在食物中放安眠药，小孩剂量不够，随后醒来，她随即勒毙小孩，然后自己吞安眠药自杀，不过被救活。	放	勒毙|吞安眠药自杀	1
29日零时45分，温州市公安局指挥中心接到报警，称在市区大南路招商银行前，一辆宝马越野车横穿马路，先撞开一辆正常行驶的出租车，再用车头顶着一名行人直接将其撞到招商银行里面，造成行人当场气绝身亡，肇事司机弃车逃跑。	撞开	顶着一名行人直接将其撞到|撞到	1
虐猫者往往自察能力很差，因此当内心有施虐冲动时，应首先进行情绪识别，随后再寻找被社会允许的方式进行情绪释放，如：运动、探险、蹦极等。	进行	寻找|进行	1
之后，谢永付在附近医院住了几天院，用尽了家中所有积蓄，而受助者危成龙也先后拿出9200元钱营养费，但因家中一贫如洗，却再也拿不出钱来治疗自己的救命恩人。	拿出	治疗	1
 检方起诉书指出，陈学仁2004年起利用网络聊天认识女网友，再带到高速公路桥下涵洞、树林、偏僻产业道路性侵，先后有12人受害。	性侵	受害	1
患者声音：挂号中介，多数人不买账预存100元，其中含60元会员费，挂号再补交钱，从第一次成功预约起开始划扣会费，每月5元，直到预存费用用完。	补交	划扣|用完	1
市交委：属实将严肃处理“第一，教练员不能随意改变教学线路，更不能在工作时间将车开回家；第二，只有所缴学费达到一定额度，才能享受VIP服务，当日对蒋玲的一对一路训是违规的。”	处理	改变	1
只听“砰砰”几声，车身先是刮过路对面人行道上的一棵小叶榕，将巴掌大的一块树皮蹭掉，改变方向后撞向一家餐馆，将安装在外墙上的空调外机挤得严重变形，紧接着撞碎餐馆的两扇玻璃门，整个车体倒着冲进了餐馆大堂里。	刮过	蹭掉|改变|撞向|撞碎	1
40天的时候，到武汉一家医院看过，专家建议先观察一下，到半岁的时候再复诊。	观察	复诊	1
华工邱副校长告诉记者，此举是为了让90后大学生从开学第一天起就学会独立，不再让家长代劳，而把庞大的家长团引导到看台上有利于报到现场的秩序。	学会	代劳	1
目前，苗军无法出示任何车辆证件，因此民警们要先将该车暂扣，再对车辆身份进行详细核实。	暂扣	核实	1
第一个球“啪”地弹出了篮筐后，小何景接着连续投篮11个全中，最终在120秒内投中22个3分球。	弹出	投篮	1
当晚9时30分，他赶到美博城，随后帮王先生查看了订单，之后便准备离开。	查看	离开	1
对方一男子在电话中对蒋勇说，“你不要着急，先去医院把伤治疗好了，再协商赔偿事情。”	治疗	协商	1
刘帅说，第一个月赔钱，第二个月就实现了赢利，如今已经发展了20多个会员，接了100多单生意，公司由原来的3名专职员工增加到了6名，同时还录用了近20名兼职员工，他透露，他们还将把业务扩展到帮别人建立网站、清除计算机病毒等智力型方面。	赔钱	实现	1
先是小区的电动车和自行车车座被人用刀片划成了鱼网状，接着又有居民家门上的猫眼被人恶意塞上曲别针和大头针。	划成	塞上	1
患者家属质疑吸氧费多收唐先生称，两个月前的7月3日，87岁的老母亲转院至重庆市五里店长安医院，7月12日，由于病人吃饭被噎住仅吸过一次氧，但在之后的一个半月中，病人吸氧费用却日日出现在每天的费用清单中，直到8月25日，唐先生发现后向主治医生反映，院方才停止了这项每天77元的供氧收费。	质疑|多收	转院	1
■麻醉问题引发医患打斗据赵先生的爱人李女士介绍，21日晚22时许，朋友的脚被玻璃碴扎伤，赵先生陪同去涿州市第二中心医院治疗，急诊科一位卢姓大夫接诊。	引发	扎伤|治疗	1
在中山医科大学第一附属医院，她被确诊为上左股骨下段、左胫骨上段“多源性骨癌”，并肺转移，医生建议桂秋先治疗两到三个疗程，再进行截肢手术。	治疗	进行	1
据韦光永回忆，双方如此僵持了约20分钟，韦光永害怕对方开枪，就提出先回村里，再解决砍树的事。	提出	解决	1
不过在几周时间内，我的眼皮‘瘫痪’开始变得规律起来，它们会先闭上3天，然后又会恢复正常3天，接着它们又会旧病复发，再次闭上3天，如此周而复始。”	闭上	恢复	1
他建议家属可先到劳动部门申请工伤鉴定，再通过法律程序索赔。	申请	索赔	1
3月15日，王鑫聘请湖北鸣天律师事务所黄先元律师为代理人，书写诉状，将彭涛作为第一被告、周颖作为第二被告、程锈作为第三被告一并告上法庭。	聘请	书写|告上	1
于程说，这些费用他先透支下个月的生活费，再通过做家教、做商场促销等兼职来填补这个“漏洞”于程说， “或者先问同学借，实在不行就透支信用卡。”	透支	填补	1
此时，倚靠岩壁坐着的刘先生在吃完了从山下带来的6个苹果后，由于寒冷、饥饿和恐惧，他的情绪再次变得焦躁，并在神志不清的状况下出现了幻觉。	吃完	变得	1
【同期】刑警队 亢吉鹏：在讨论这个案情的时候就感觉这种人，第一是有前科，第一次干他没有这个胆量干这个事，第二就是说吸毒成瘾赌博成瘾马上需要大量的钱。	干	需要	1
乔尔回忆说：“第一张彩票打印了出来，上面写着的时间是8:59；可第二张彩票却在9点过7秒后才打印出来。”	打印	打印	1
乔尔回忆说：“我在晚上9时前输入了两个彩票号码，第一张彩票打印了出来，上面写着的时间是8时59分；可第二张彩票却在9时过7秒后才打印出来。”	打印	打印	1
依照药品安全法律法规的规定，药品出现不良反映，医院首先要向政府药品监督管理部门报告，然后对药品进行检测。	报告	检测	1
昨天，参与处理善后事宜的一位民警向记者透露说：“赔偿基本已经谈妥，由事故处理组先期垫付26万元，待公安机关侦破结束后再按照国家法律进行刑事等责任的追究。”	垫付	侦破|进行	1
男子酒后疑被小偷送回家 贵重物品不翼而飞本报讯 家住南京龙江小区的黄先生遇到一件怪事情，10日晚上，他和朋友在南京大学附近一家饭店喝酒，酒后，最后的记忆就是独自从南大校园里出来，再往下自己就什么也想不起来了。	遇到	喝酒	1
王甜、张姣和李贝在蛋糕房购买了一个生日蛋糕之后，先期到达了酒吧。	购买	到达	1
 这样的条件，卢佳本该生活无虞，但每到月底，她却焦急万分，“先是手机上频频接收到催款信息、紧接着电子邮件也在提醒该还钱了……”让卢佳苦恼的，正是手里的三张信用卡。	接收	提醒	1
随后，他将取出来的延时阀塞入事先准备好的袋子里，然后若无其事地进入其他的卫生间，不知情的人还以为他是维修工呢！	塞入	进入	1
罗吉尔先用木棍袭击苏珊，再用刀将她刺死。	袭击	刺死	1
另一拾李某昨天则没有再喊出任何价格，只是说这鹿是个“贵重物品”，要肖师傅先出价，加价加到他满意时，他才肯归还梅花鹿。	再喊出|喊出	归还	1
在工作人员的帮助和建议下，钟先生决定回老家先把父亲接来，让老人家先领取大奖，自己再补办身份证，重新开户转账。	领取	补办	1
云南省贸易经济学校王校长说，事发时是假期，学校拿不出钱来，值班老师提出先由学校担保救治，等到徐立均出院后再统一结算，当时医院也同意学校的担保，并在学生凑了150元的情况下办理了住院手续并进行救治。	提出	结算	1
头部包扎着纱布、衣服上沾满血渍的司机王成桂，拿着东莞市公安局虎门分局白博派出所出具的证明材料对记者说，16日下午1时，他们驾驶长途客车从东莞虎门站出来，没过多久就发现有人故意往客车前轮胎下撒钉子，他们第一次避开了，但没行驶多远对方又驾驶一辆无牌小汽车追上来，再次往客车轮胎下扔钉子，他们只好停车，下车想清除轮胎附近的钉子。	避开	驾驶	1
市民组成文明使者送花感化违反交通法规者本报讯 昨天，在泰州高港区活跃着两支共30人的“文明使者”队伍，手拿鲜花的“文明使者”，不时有选择地将鲜花送给一些“特殊”市民，让人吃惊的是，有幸被送鲜花的市民每人都有不文明的行为，这些市民接受鲜花后先是尴尬，再就立即改正自己不文明的行为，很多人还当场表示以后再也不会犯同样的错误了。	接受	改正	1
目前已有一名学生开始在刘先生家试讲，一个月后再根据效果决定是否签约。	试讲	决定	1
男子坐霸王车被拒劫杀出租车司机本报记者 赵杨 通讯员 黄艳玲 甘丽琴本报讯 罗源一男子想先到福州，再去龙岩打工，可身上的130元不够坐车，于是他想到坐“霸王车”，被的哥拒绝后杀人抢车。	坐霸王车被拒劫杀|被拒劫杀|劫杀	打工	1
据悉，张欢是十月五日来到福建，已先后在莆田和龙岩开展活动，在泉州是其福建之行的第三站，之后还要到特区厦门参加活动。	开展	参加	1
在插秧赛中，选手们先挑起两个秧筐，跑到15米外，把300棵塑料秧苗分别放进筐内，然后挑着秧苗跑到插秧区，手持塑料秧苗，在有300个圆孔的插秧板上进行旱地插秧。	挑起	放进筐内，挑着|挑着	1
郑某某交待，自2006年以来，先由村民提出购买摩托车的型号、式样，再由郑某某通知犯罪嫌疑人叶某某、王某某、陈某某等按要求盗窃摩托车，先后卖出盗窃来的摩托车27辆。	提出	通知|盗窃	1
车子开了一段时间之后，就在江北一家小旅馆前停了下来，小美先被带进了房间。	开了	带进	1
2月28日，韩子再次与石先生商量出国旅游结婚，并以办护照的名义从石先生那里拿走了19万元现金、石先生身份证、存折和银行卡等物。	商量	拿走	1
种田养家的张强觉得这针太贵了，再加上当地的医疗条件不够，只能接种狂犬病疫苗的第一针，然后还要坐车到县城去接种后面几针。	接种	接种	1
去年7月，高雁搬离了原先的住处，重新找了房子租住，可是不死心的范名再次找到了她，经常来到她的屋里求情。	搬离	租住|找到	1
随后，费先生拒绝进医院和等待警察，带伤跟踪男子到住处，然后配合警察将行凶者抓住。	进医院和等待|等待	配合|抓住	1
瞿久刚代表国家交通运输部海事局宣布了3个决定：第一，由交通运输部成立调查组赴深调查；第二，在调查期间，停止林嘉祥(编者注：林嘉祥任深圳海事局党组书记、副局长、纪检组长)的工作；第三，根据调查结果将进行严肃处理。	宣布	成立	1
瞿久刚代表国家交通运输部海事局宣布了3个决定：第一，由交通运输部成立调查组赴深调查；第二，在调查期间，停止林嘉祥的工作；第三，根据调查结果将进行严肃处理。	宣布	成立	1
随后不愿意再做任何表态，李先生此时发现为他理发的罗师傅已不知去向，手机也关机了。	再做	理发|不知|关机	1
下午3时左右，记者陪同李先生拿着医疗发票再次来到金龙路的花仙子休闲会馆讨要说法。	陪同李生拿着|拿着	讨要	1
工商部门：难拿证据协调无果建议消费者走法律途径维权金龙工商所的工作人员来到现场协调，李先生提出商家在负责全部医疗费的同时，再对他赔偿误工费、车马费以及精神损失共计人民币5000元，而现场负责人杨主管仍然表示“此事我不清楚。”	负责	赔偿	1
案情逐级上报之后，公安部禁毒局当天就把此案列为公安部2007年禁毒第一大案。	上报	列为	1
原是前男友不甘心分手据韩铃介绍，当第二次从门卫大爷手中接过凋谢的玫瑰后，她就怀疑骚扰者是原先工作的花店员工范某了。	接过	怀疑	1
原是前男友不甘心分手据韩铃介绍，当第二次从门卫大爷手中接过凋谢的玫瑰后，她就怀疑骚扰者是原先工作的花店员工范某了。	接过	怀疑	1
 离婚后，李先生仍然无法接受这个现实，于是又一纸诉状将前妻赵女士第二次诉至法院，要求赵女士返还抚养孩子八年的抚养费，并赔偿精神损失。	接受	诉	1
见面之后，女子称想找个地方坐坐，吴先生便随她来到本溪路上的一家餐厅。	见面	来到	1
据目击者该厂另一名员工汪先生说，死者先是在松山湖这边被人实施抢劫时砍伤的，然后翻过交界处的土坡，一路跑到寮步镇的石龙坑社区入口处才倒下的。	砍伤	翻过	1
他先通过扫描程序找到北京网通可侵入的客户电脑后，植入木马程序“灰鸽子”，然后通过IE代理软件冒用网通客户名义进行购买游戏点卡等，最后以3折至5折的低价卖给淘宝商家。	找到	植入|冒用|购买	1
首先是拿出一部分捐助希望小学；第二是帮助身边困难的亲属；第三是给儿子购买新房。	捐助	帮助	1
下午3时，经协和医院检查，实习生晏利利多处外伤及软组织受伤，头部因摔倒时先着地，医嘱24小时后再检查。	着地	检查	1
14岁那年，王洁交了第一个男朋友，并搬了出来和男朋友同居，毕竟在这里她能感受到男友的温暖，但一年之后，男友出车祸死亡。	交了	同居	1
而被强留下的王洁第一次接受老板张爱国“面试”时，被告知“工作要求不高，薪水还可以”的工作是卖淫，王洁断然拒绝，但换来的是一顿毒打，被打晕的王洁被关进一间狭窄阴暗的房间，待她醒来之后，再次遭到张爱国的逼问“做还是不做”？	接受	拒绝	1
由此我们可以清楚看到张黎通过网络交易逃税的整个过程：先以公司的名义向厂商进货，但并不向厂商索要发票，在公司账目上也不登记，再通过网络与客户联系，出售婴儿用品，客户把钱款打入张黎的个人账户，网络上的交易同样不记账，不开具发票。	进货	索要|登记|联系	1
趋势三：铁杆光棍又蝉联“中国十大光棍”的评选从2006年开始，今年已是第三届，每一届的人选都会有很大不同，譬如今年的杨紫琼、袁立、王朔、易建联、张怡宁、何雯娜、龙清泉都是第一次入选，张艺谋和李湘已是第二次当选，但名字“很光棍”、又出生在“光棍节”这天、去年开始还被中国光棍协会聘为形象代言人的“光棍作家”张一一却是上演了“帽子戏法”第三次蝉联，获此“殊荣”的张一一表示，自己与“光棍节”的缘分很深，也非常荣幸又一次当选“十大光棍”，“伟大的作家往往都需要忍受常人无法忍受的孤独和寂寞，我会把光棍事业继续发扬光大”。	入选	当选	1
凌晨5时许，赵某趁何某熟睡之机，从厨房拿来一把菜刀和一块砧板，先持砧板击打何某的头部，接着用菜刀切割何某的颈部，致何某当场死亡，之后，赵某拿起何某的手机和MP3逃离现场。	击打	切割	1
今年6月底一天凌晨，觉得万事俱备的梁刚成进入了小区，通过撬门攀爬首先进入了屋主儿子陈亮的房间，陈亮早已熟睡，梁刚成掏出尖刀抵在男孩的脖子上之后，这才喊醒了陈亮。	进入	熟睡|掏出|抵在	1
 所谓“抗衡如来”，悟空准备了两手，首先还是希望凭借过人的才智和不畏艰辛的品德征服如来，让他认为自己的篡逆属于合理禅让；其次才是笑里藏刀，万一如来不答应，再以师徒四人即“一心四相”的新面貌新阵容与他重决高低。	征服	重决	1
第一次采集完后，隔两个月到8月20日，就可以第二次锯鹿茸了。	采集	次锯	1
因此决定先让张培伟继续养护着，待野生动物保护部门拿出救护方案，找到合适的养护地点后，再决定其归属。	养护	拿出|决定	1
据此，泰兴交巡警大队终于下达了交通事故认定书：认定在第一起交通事故中，朱好过错和违法行为作用较大，负事故的主要责任，王年伯负事故的次要责任；第二起交通事故中，雪佛兰司机的过错起直接作用，负事故的全部责任，王年伯妻子无责任。	认定	作用	1
双方约定先由朱先生去医院检查额头的伤势，以后的事情3天之后再去派出所协商解决。	约定|检查	协商|解决	1
该男生认为，先挤进政府机关当外聘人员，是“曲线救国”的好办法，干上一两年后，拥有政府机关的工作经验，再考公务员，也许会在考试资格审核、面试等环节一路绿灯。	挤进	拥有	1
上海警方经勘查发现，作案人为一名身着深色服装、脚穿白色运动鞋的青年男性，中等身材，并曾先后两次进入遇害女模特所居住的小区，第二次离开时还取走了女模特室内的笔记本电脑、数码相机、首饰、拉杆箱等财物。	进入	取走	1
在杀死妻子后，杨俊先是割腕自杀，未果，然后双手连接室内照明电线，触电身亡。	割腕	连接	1
从小柏老师家出来后，两人决定抢劫他，并决定先逼他说出存折密码，然后将他打昏，再强行向其嘴里灌农药制造其自杀的假象。	说出	打昏	1
昨日，贵阳市第十六中学的法人、书记、校长樊跃告诉记者，“事情发生后我在第一时间对刘老师作出了处理，考虑到刘老师经常受到老师和学生们的欺负，再加之认为事情发生当天，没有多少人看见大屏幕显示的内容，影响不大，所以动了恻隐之心，对刘老师的行为只进行了批评教育，并通报批评。”	发生后我在时间对刘老师作出|作出	受到	1
第一时间得知女儿病情的李父不忍心将这个消息告诉妻子，他怕妻子无法承受再次失去子女的打击。	告诉	承受	1
该“客服”告知邓先生先将10000元存好，等银行开门后再到银行取卡。	存好	开门后到银行取卡|取卡	1
她本打算换煤气包，于是先行将安全阀拧开，但弄了半天也没搞好，于是再把阀门拧好。	拧开	拧好	1
恐吓敲诈多个方便面企业收到有毒调味袋“总经理：同你废话少说，这是一封警告信，你说是敲诈信，恐吓信也罢，随信一同寄到的方便面粉包你先去化验一下，得到结果后，再看我开出的条件……”2007年3月19日上午，以“雪菜肉丝”方便面而闻名的无锡中萃食品公司老总收到一封信，来信勒令该公司在3月28日前，向某某账号打入10万元人民币。	化验	得到结果后，看我开出|开出	1
肇事司机剐蹭公交车后逃逸再撞四位老人当事人称司机不辞而别 是否酒后驾车正在调查本报讯（记者陈坦）今晨7时许，在宣武区太平街中央芭蕾舞团门口，一辆白色奇瑞轿车在路口与一辆66路公交车发生剐蹭后逃逸，在逃逸过程中先后撞倒4位上公园锻炼的老人。	剐蹭	发生|撞倒	1
按约定，“申江公司”会每月给予投资者回报，“(每辆车)第一年每月回报7800元，第二年每月回报7500元，到第五年，就每月回报5700元。”	回报	回报	1
对此，厂方认为，该厂能够提供两份证人证言证明赵英琴以签订新劳动合同需要为由，欺骗员工在空白纸上签名，然后粘贴到事先拟定的文件中，通过电子邮件发给丹麦的董事长等人，该行为属故意扰乱工厂管理秩序，严重违反了劳动纪律。	签名	粘贴|扰乱|违反	1
拍完裸照被逼“出台”进了屋，何姿先让小丽打扫房间，然后再命令她蹲在墙角，还不停地骂她。	打扫	命令	1
怕父母“棒打鸳鸯”，女孩开始帮助男孩创业，首先拿出一部分积蓄，给男孩开设了一家服装店，然后再建议男孩读书深造。	拿出	开设|建议	1
根据院检调查，张家荣从2001年7月开始就在台中犯下第一起偷拍案，当时台中地院依妨害秘密罪判处拘役40天、得易科罚金；第二次于2003年9月在台北诚品书店犯案，这次被判刑3个月有期徒刑、得易科罚金。	犯下	判处|犯案	1
近年来，李赛凤因为转为幕后工作本来已逐渐淡出了人们的视线，但是前不久，一场有关李赛凤的名誉权官司，在北京市第一中级人民法院公开审判，让她再次引起了社会的关注。	公开|审判	引起	1
事发轿车追尾钻进挂车屁股下李先生说，昨日凌晨零时许，他开着一辆银灰色现代伊兰特轿车，带着两位朋友去南京，参加第二天的一个商业活动。	钻进	开着|带着|参加	1
主刀副教授何奇元介绍，由于不得硬拔铁叉头，他们只能先取下袁敏的头盖骨，然后从头盖骨上拔下铁叉头，最后再将头盖骨移植回颅内。	取下	拔下	1
术后四个月，秀玲的脖子彻底不能动了，医生说第一次手术没清除干净，这样，当时只有5岁的小秀玲又经历了第二次手术。	清除	经历	1
男子持木棍将老太当街打死 称我不杀人人即杀我市场报讯(张振山 汪永生 王涛)11月24日，省城闹市街头突发血案，一男子手持木棍先是将一老大爷打成重伤，接着又将一老太太当场打死。	手持|打成	打死	1
王先生：当时我下班骑摩托车经过那里，看到一个年轻人手里拿着木棍，朝着一个老大爷的头部猛击，老大爷当时就被打倒在地，然后那个人就跑了。	经过	手里拿着|拿着	1
于是，他首先蹿进赵艳母亲的屋里杀人灭口，接着翻出800多元钱并拿走赵艳的手机，随后逃逸。	蹿进	翻出|拿走	1
“那人一冲上来就先捂住我的嘴，然后掐住我的脖子，把我往卧室里面拖，并威胁我不要喊。”	捂住	掐住	1
尽管冯某一再否认，但浦口区法院凭借着有力的指纹证据，在“零口供”的情况下，认定冯某就是入室抢劫郑先生的罪犯。	否认	认定	1
据法院审理查明，2007年2月至2008年4月期间，李明宇以创办的广告公司为幌子，先后纠集被告人胡小梅等28人，以“富婆”“富商之女”等为广告角色，在全国上百种报刊上发布虚假的征婚、交友陪游、借种生子等广告，以支付高额回报为诱饵，再由胡小梅等人冒充广告角色、“红娘”，骗取应征者信任。	纠集	发布|冒充	1
24日晚11点多女事主与男朋友到警署时，梁让女事主的男朋友先离开，随后将女事主带到一间无人的房间，实施强奸，直至第二天凌晨1时许才让她离去。	离开	带到|实施|离去	1
他们先将老赵的头部蒙住，然后将嘴、眼用胶布封了。	蒙住	封了	1
紧急排查走访根据现场痕迹勘查的结果，侦查员勾勒出了犯罪嫌疑人的作案轨迹：犯罪嫌疑人先从现场东南侧围墙攀爬至2楼，因无法打开窗户遂再次从西南侧围墙爬入后，打开靠西南房间的底楼窗户再进入2楼，在对被害人先行加害后翻动物品进行抢劫。	攀爬	打开	1
首先获得女性的青睐，抓住对方的心理，然后再对自己进行一番伪装，并许诺会给与一定金钱上的资助，以彻底摧垮对方的心理防线。	获得	抓住|伪装	1
前日早上5时，黄先生驾驶电动车被这头水牛撞倒，“当时也是有人按喇叭，水牛受了惊，直接一头顶在我的电动车后面，然后往仲恺方向跑，我扶起电动车跟在它后面，跟了大约3公里，就看到它把吕先生顶翻在地。”	驾驶|撞倒	受了惊，直接一头顶在|顶在	1
李先生以为是谁家在吵架也没在意，去了趟卫生间后接着睡觉了。	吵架	去了趟卫生间后睡觉	1
警方迅速破案，原来是一伙犯罪分子利用在ATM机附近安装读卡器、MP4等手段，窃取了王先生的卡号和密码，然后又用复制假卡的手段从其账户上支取或消费了巨款。	窃取	支取|消费	1
3日晚7时58分，王先生又在光华路的一处自助柜员机上取款5000元，取完款后他还接着查询了卡上的余额，数据显示他的卡上还有463942.2元。	取款	取完款后他还查询|查询	1
11月1日，赵燕来到新疆医科大学第一附属医院再次对体内异物进行检查，结果为“耻骨联上缘偏左见横形高密度影”，异物约5厘米，比以前的医生说的10厘米少了5厘米，她找到县医院时，医生解释“可能是在做二次手术时把金属片的方向改变了。”	来到	检查	1
据他介绍，在10月20日向法院递交诉状时，他提出了经济赔偿，但是这次改变主意了，他计划先通过法院状告撤销崇安分局的处罚决定，然后再申请国家赔偿。	通过法院状告|状告|撤销	申请	1
过了几分钟，她似乎耐不住同事热情怂恿，匆忙出去从李先生手中接过玫瑰，然后躲进了工作室。	接过	躲进	1
据郑州市中原区人民法院审理查明：1998年至2000年期间，谢连才利用任郑州市第二人民医院院长的职务便利，在该院采购医疗设备过程中，先后两次收受供应商北京市凯达佳商贸公司郑州分公司张某现金共计8万元，并为其谋取利益。	利用	采购|收受|谋取	1
她先给谢丽尔拍摄了两张照片，一张是她化了浓妆的照片，一张是她素面朝天的照片，然后安德里娅陪谢丽尔来到城市街头，问每一个路人他们更喜欢哪张照片。	拍摄	来到	1
刑满释放男子再次编造虚假恐怖信息获刑5年荆楚网消息 (楚天都市报) （记者王小晗 通讯员彭琛 喻英辉 实习生廖丰）武汉男子方星桥，曾是我省第一个因“编造虚假恐怖信息罪”被判刑的人。	编造	判刑	1
当记者对他所说的话表示怀疑时，对方便把制作假证的内幕大概叙述了一遍：先在网站上随意输入一个准考证号或者用办证者提供的准考证号，把分数复制下来，再打印到成绩单上。	输入	复制|打印	1
接着他和邓清安就被乘警叫到列车餐厅，乘警先要郑清安交出火车票和身份证，然后说郑清安携带黄色书刊要罚款50元，如果不拿钱，就别想拿回火车票和身份证。	交出	携带|罚款	1
男子冒充派出所长诈骗多名农户获款7万本报讯 （记者 杨野）先冒充电信职工，以检修电话故障为由到农民家中了解情况，然后再冒充外地派出所长，给这些农户打电话，谎称其亲人犯事要钱解决。	冒充|诈骗	检修|了解|冒充	1
海淀法院认为，联想公司已支付张先生经济补偿金，张先生不能证明受到胁迫，也不能证明身体受伤害，联想公司无须再补偿。	受到	补偿	1
“在法律意义上说，没有试营业这一说法，”潘所长介绍，从法律程序上来说，任何经营性质行为，都应先办理营业执照，然后再进行经营。	办理	进行	1
张某建议先把儿子卖掉后再考虑重新建立家庭比较顺利。	建议|卖掉	考虑重新建立|建立	1
第二任妻子过世后，和老汉合葬在一起，但第一任妻子所生的儿子张桐（化名）却擅自挖开坟墓，将父亲的尸体挖走火化，和母亲合葬。	过世	合葬|挖开|合葬	1
此时，陈先生已经发现手夹包丢在出租车上，正在根据打车发票报警，接到民警电话后，迅速打车赶到了北京西路，将手夹包领回，并对阎师傅再三感谢。	发现	报警，接到|接到|赶到了北京西路，将手夹包领回|领回	1
很快，她就发现了公司大客户的业务突然异常消失，心生疑窦的她先是从公司员工口中获得了大致线索，然后又专程前往苏州找到了客户单位，最终得知了业务款的去向，继而报警。	获得	前往|找到	1
马老太给付第一任妻子房屋补偿款18万余元，给付第二任妻子房屋补偿款4.5万元。	给付	给付	1
养鱼池是山东人李先生夫妇于两年前修建的，夫妇俩将从东北买回的鲜活红鳟鱼放在养鱼池中，然后再送往北京城区等地销售。	修建	送往北京城区等地销售|销售	1
张某为她出了个主意：身边带着儿子想找个好人家很难，不如先把儿子卖掉，再考虑重新建立家庭。	卖掉	建立	1
随后，又赶往市场购买了大型旅行箱和编织袋，先将尸体装入编织袋再装入旅行箱。	装入	装入	1
一名香港男子先是在深圳制毒因冒出大量浓烟逃离现场，接着又转移到广州番禺制毒，结果发生爆炸被当场抓获。	制毒	制毒	1
男子假造文书诈骗典当行205万元□记者 姚克勤 通讯员 李鸿光 晨报讯 现年27岁的王文为牟取不义之财，竟雇佣八旬老太冒充已故十余年的祖母，先炮制虚假公正文书，变更了祖母房产产证，再将房屋抵押给典当行骗得205万元。	炮制	变更|骗得	1
 为了搞到钱，王文向熟悉房屋买卖流程的陆某打听，得知先要把祖母的房屋产权证过户到母亲名下，然后才能顺理成章办理房产抵押贷款业务。	得知要把祖母的房屋产权证过户|过户	办理	1
6男子矿井下杀人伪造安全事故 专骗死者赔偿金□记者谷武民通讯员宋景民本报鹤壁讯先是6人结伙同到煤矿下井，再向老板介绍“亲戚”入伙，然后杀人后制造塌方、冒顶事故假现场，最终以死者亲属的身份向矿主骗领死亡赔偿金。	伪造	介绍	1
到目前为止，余晖走过的五家店面已经关闭了3家，而公司在高峰时期猛烈扩张也留下了很多问题，不管是否赚钱，先开个店再说的策略给2008年埋下了隐患。	开个	埋下	1
他想在春节期间攒下自己的“第一桶金”，然后摆个走鬼档做点小生意。	攒下	摆个走鬼档做点	1
圆脸男子奋力靠近落水男女，然后一手抓住一个，半分钟后，圆脸男子渐渐体力不支，无奈之下松开双手，先前落水的两男女渐渐被锦江吞噬。	抓住	松开|吞噬	1
信息时报记者 李朝涛 通讯员 黄义涛 张启祥信号突然中断方知发射塔不翼而飞2008年4月，中国联通有限公司梅州分公司先后接到梅县畲江和石坑两地的用户投诉，说通讯突然中断，而且再也信号。	接到	中断	1
于是东东被送到该院急诊科进行救治，同时，有关部门也开始协调不同部门，最终决定，先把东东送到河南烧伤专科医院——郑州市第一人民医院进行救治，然后再寻找其父母。	送到河南烧伤专科医院——郑州市第一人民医院进行|进行	寻找	1
第一次减员他们为这个城市工作了近四年时间，突然之间这个城市再也不能养活他们。	工作	养活	1
国庆假期后，负责管理临时促销员的一位LG公司员工孙先生称，工资会在11月底支付，然而，之后便始终以正在休假或办理离职手续等原因推托，最后一次，他承诺12月31日前付清，却仍然无法兑现。	管理	支付|推托	1
县城供水管道一年爆238次(图)本报记者 卿荣波 摄本报渭南讯(记者 卿荣波)合阳的方先生气喘吁吁地提起水桶从一楼上到五楼，昨日，因为县城的供水主管道再次爆管，他不得不从朋友那里接水。	爆238次(图)本报记者卿荣波摄本报渭南讯(记者卿荣波)合阳的方生气喘吁吁地提起|提起	爆管	1
警官首先调取死者的资料，记者听到他们在念：“死者父亲黄德林，姨父……”随即张警官拿来了见义勇为者的笔录，他念道：“黄……”“他也姓黄，这更巧了!”记者吃惊地说，随即张警官再也看不下去了，“黄德林，43岁!”他喃喃自语：“好像刚才查到的死者父亲就叫黄德林!”“不会吧!”在场所有人都不敢相信，张警官摇着头到电脑前核对，结果确实无误!民警随即电话通知了黄德林，电话那头，黄德林半天没有说话。	调取	念：“死者父亲黄德林，姨父……”随即张警官拿来|拿来	1
10点半到达第一家银行，也是开设账户最多的银行，冻结了198万元：第二家银行，账户没钱；第三家银行，账户只有几百元；第四家银行，账户上仅有的30万元已被转移；第五家银行，终于冻结了100万元。	到达	开设|冻结	1
而且第一笔钱转给我已有半年，第二笔钱转给我也超过一个月，哥哥直到临死前也没和子女说过‘钱暂放妹妹那儿，等我死后再让她交还给你们’之类的话。”	转给	转给	1
对于孰是孰非，民警没有表态：“今天先带到派出所，明天调查以后再作出处理。”	带到	作出	1
之后迪吧保安队长陈某出面，带着内保人员持橡胶棒、镀锌管、刀具等殴打黄先生、王先生，黄先生经抢救无效死亡，陈某案发后潜逃。	出面	殴打|死亡|潜逃	1
邱女士遇袭的消息传开后，在住户当中引起了轩然大波，因为此前该小区曾经先后发生过数次歹徒锤击居民、然后实施抢劫的先例。	锤击	实施	1
据介绍，该诈骗手法在台湾称为“乱枪打鸟”，即通过互联网和电话黄页等方式收集目标对象资料，然后冒充司法机关和银行工作人员，逐步诱导事主将个人名下的存款汇入诈骗分子事先准备好的银行账户内。	冒充	汇入	1
王军称，唐某出示了公司打到其银行卡里的对账单，第一个月就进账5000多元，第二个月又进了几千元，第三个月就进了3万多元，他一下就心动了。	进账	进了	1
2008年8月5日16时许，郭祥云携带事先准备好的瓶装2.5升汽油来到周某的办公室，再次讨要欠款，遭到拒绝。	携带|来到	讨要	1
2004年3月30日，肖先生给他出具过一张欠条，之后陆续还款2万余元，现在仍有8万元没有归还。	出具	还款	1
他扬起手中的一瓶绿茶，先砸向持刀的高个男子的尖刀，再击中其头部。	砸向	击中	1
 随后，苏某将假钞放在钱包中备用，有顾客持百元面值的人民币前来购买活鸡时，便接过顾客的钱，假装在钱包中找零钱，并以极快的手法将顾客支付的真币与包内事先准备好的假币调换，然后再把假币还给顾客，并借口说没有零钱找给顾客，让顾客自己去调换零钱再来购买。	支付|调换	还给	1
曾先生（天天的舅舅）：妹妹去世后，外甥女一直由我们夫妇照顾，生活得很好，如果再转由他人监护，可能对孩子身心健康造成影响。	去世	照顾|监护	1
这位中奖者也是常客，通常购买256元的复式票，这次他先电话投注1张64元复式票另加机选2注；隔了一段时间又打电话再投注了一张64元复式票，再过一会又打电话过来再追投了1注，一天之内连续三次进行了电话投注。	投注	追投	1
承办法官按照事先确定的调解方案，先控制住陈某的情绪，然后向他解释法律规定。	控制	解释	1
在幸运来到这个世界之后，医生先让小阿雅在母亲肩膀上停留片刻，而后交到父亲马赫穆德·索里曼手上。	来到	停留片刻，而后交到|交到	1
上街区卫生局出具证明称设备正常老人去世后的第二天，王先生就找到了上街区卫生局反映此事。	出具	找到了上街区卫生局反映|反映	1
这其实已经是王超第二次这样从相同的位置后空翻了，第一次安然无恙，而这次却是头皮被撕开一大块，头盖骨错了位，脊椎骨折，落下了截瘫的终身残疾。	空翻	落下	1
摩托车驾驶员肇事逃逸后再次发生车祸身亡金报讯 (通讯员 陈卫东 记者 戴晓燕)一辆牌号为浙BSY299的摩托车在被盗3小时后，驾驶员先撞了一辆自行车，肇事逃逸2.5公里后，又撞上一辆电动车，最终，摩托车驾驶员送医院抢救无效死亡。	肇事逃逸|发生	撞了	1
小黄觉得最重要是先找到工作干起来，一则养活自己、不再向家里伸手，二则可以边干边学、“学到的都是自己的”。	找到	养活	1
“一个理性的人，会先接受现状、再改变现状。	接受	改变	1
 证监会调查发现，汪建中利用北京首放及其个人在证券投资咨询业的影响，借向社会公众推荐股票之机，通过“先行买入证券、后向公众推荐、再卖出证券”的手法操纵市场，非法获利。	推荐	操纵	1
医生再三追问病史才了解到，李先生早晨曾经吃过排骨。	追问	吃过	1
鹭鸟受高空爆竹声惊吓坠地(图)先是一声“钻天猴”的爆炸声响起，紧接着一只大鸟从天上摔落，砸在了市民陈先生面前。	受	摔落	1
当晚约9时40分，刘放军先用电线电死前来开门的岳父刘迪和，然后在二楼拐角处用匕首刺死闻声而来的岳母王淑兰，接着跑到二楼走廊对着正在呼救的妻子刘凤华连刺几刀。	电死	刺死	1
消息又称，有人被捕后表现合作，供述杀人经过，声称先租用一辆市区的士，到铜锣湾礼顿道近伊荣街接陈某下班，杀人后用该的士移尸到元朗牛潭尾竹攸街山边沙井弃尸，然后扮作若无其事往交还的士。	租用	扮作	1
大年三十晚上，蒋先生喝了3两酒再次抱着儿子打针后，23点左右体力不支突然睡倒，宝仔也从他怀中顺势摔了出去。	喝了	打针	1
回忆起当时的情景时，宝仔妈仍心有余悸：“先睡下的我被‘咚’的一声惊醒，接着听到宝仔大哭一声便没了声音。	惊醒	没了声音	1
无奈之下，朱某与丈夫商量先协议离婚，躲过债主的纠缠，等事情过去再复婚。	商量|协议	复婚	1
而高某一直再未与江先生联系，江先生认为事有蹊跷，随即报警。	联系	报警	1
维修人员查看后称，李先生的手机中了恶意代码，一些人利用这种病毒让接收者的手机变成免费的短信群发器，需要格式化再重新安装操作系统。	中	利用|变成|格式化重新安装|安装	1
在他的坚持下，雅培公司从开始的承诺一赔一，到一赔三，再到答应带赵先生的女儿进行全身检查，并收回了赵先生购买的所有雅培奶粉。	答应|进行	收回	1
雅培提出一赔三方案赵先生再次拨打了雅培公司的服务热线。	提出	拨打	1
为抢时间，抢险救人指挥部决定：先由消防官兵爬上电塔先控制住刘某，等断电后再将其救下。	爬上|控制	救下	1
 万元存款被取法院判储蓄所赔 法院审理认为，在特殊情况下，储户可以用口头或者函电形式申请挂失，因曾明的有效证件均已被盗，火车站储蓄所应先予挂失，然后要求原告在规定的时间内补办相关手续，但该储蓄所未作为，致原告存款被取走。	挂失	补办	1
朱某先将随身携带的安眠药放入事先买来的饮料中，将林某迷晕，再朝着昏迷的林某胸腹部猛刺十几刀，然后在自己的手腕划了几刀，预图割腕自杀。	放入	迷晕|猛刺	1
法院审理后认为，朱某以非法剥夺他人生命为目的，先用安眠药将林某迷晕后，再使用水果刀捅刺被害人十几刀，致其重伤，其行为已构成故意杀人罪. 近日，浙江永嘉县人民法院以故意杀人罪判处朱某有期徒刑六年，并赔偿前男友林某人民币共计40205.4元。	迷晕	捅刺	1
2007年的一天，曹某(已和陆某结婚并有两个孩子)偶然遇到赵某，二人都有了先离婚再和对方结婚的想法，二人考虑到陆某知道后会报复，决定动手将陆某杀害。	有了	结婚	1
据代某交代，2008 年12 月17 日17时许，他拦截放学回家的菁菁，在骗取菁菁的信任后，将菁菁诱骗到丰南区丰南镇么家泊村南棉花地里，用事先准备好的斧头猛击菁菁头部，又用匕首扎其颈部数刀致其死亡，然后用玉米秸掩盖尸体后逃离现场。	猛击	掩盖|逃离	1
艾莉西娅说:“我并不相信通过心理咨询或康复治疗就能够彻底戒除瘾症，不过，这却是我必须去做的最困难的事情之一，瘾症康复中心首先让你垮掉，然后再重新塑造你。	垮掉	塑造	1
其中，由第二被告张锡长提供“全国普通高等学校毕业生就业派遣报到证”；第四被告付长利提供北京市人事局“非北京生源毕业生报户口介绍信”；第三被告胡经建则以北京航润达科贸有限责任公司（2002年因未年检被注销）的名义，充当接收单位，提供伪造的毕业生接收手续；而第一被告富长宁则负责拿着这些户籍申报材料到公安局去办理假户口。	提供|提供|注销	充当|提供|办理	1
邓先生再次拨通“客服”电话，该“客服”告知邓先生先将1万元存进指定账号，等银行开门后再到银行取卡。	存进	开门后到银行取卡|取卡	1
录像显示邓先生取完1万元之后就离开了ATM机，随即便有两名男子上前操作，将邓先生的卡取走。	取完	离开	1
提到被骗的经历，河南工业大学烟草专业在校生刘剑，显得义愤填膺，“他们说付钱之前要先看东西，等到东西提交之后，就不理你了。”	付钱	提交	1
她先后去过全省不同的市州，每次回来都能分不少衣服，再在农贸市场低价卖出。	去过	卖出	1
据事后警方的调查，当天晚上，小静先是被一阵吵闹声吵醒，不知道过了多久，更激烈的打斗声将她再次从睡梦中惊醒。	吵醒	惊醒	1
宣威五中教务处的刘老师说，赵庆虎以前是他们学校的学生，他第一年考上复旦大学，第二年考上北京大学，第三年考上北京航空大学，第四年再次考上北京大学，一些老师曾经多次做赵庆虎的思想工作，希望他能够及早上大学，但是固执的赵庆虎一心想要考清华大学，坚持要补习，直到2008年当他再次考上北京大学时，才去北京读书。	考上	考上	1
“都很健康，两孩子都是我接生的，一点问题都没有”，刘君说，女孩、男孩都可以卖，女孩2万元，男孩至少5万元，已经有很多人来问过，有一户人家已决定要买女孩，所以，要买孩子的话得赶紧，可以先交钱，再带着孩子去医院检查身体，假如孩子有疾病，可以退钱。	交钱	检查	1
1997年12月到1999年1月，王某先后两次支付了400万土地出让金，却先后16次拆分该土地使用权，得到了16张土地他项权证，再拿着这16张权证贷款3498万。	拆分	得到|贷款	1
王壬上任的第一件事就是去联系镇政府、公安局，让“回超”的生存获得政府的认可；接着找北京市足协，申请给“回超”安排国家级裁判来执法。	联系	获得政府的认可	1
家长徐先生就建议，最好能电子转账，学校设置一个公共的缴费账号，家长只要按金额转账，然后将单据交给学生带回学校核查即可。	建议	设置|交给	1
两个月后，韩素华带着赵素华再次来到河南，并与郑州第一服装厂和新乡一家棉麻公司签订了合同，购买棉布和棉纱。	来到	签订|购买	1
警方赶到后，决定让程某先去医院治疗，然后再凭医院的发票商议赔偿事宜。	治疗	商议	1
引蛇出洞 警方“支付”赎金警方决定先“付”一部分现金稳住绑匪，确保孩子的生命安全，然后再伺机将其一网打尽。	支付|稳住	打尽	1
他先是用了半年时间学习电脑绘图，接着再用半年时间完成设计图，然后开始购买材料。	学习	完成	1
在小龙的一再央求下，张先生无奈地为儿子选择了“认栽”100元的树种，“这哪里是在植树，明明就是在圈钱！”	央求	选择	1
这一年，唐雪梅正在上高三，家里的状况一落千丈，她告诉记者，父亲一直鼓励她，再咬牙坚持一下，先在爸爸朋友家凑合一下，在她上大学之前，爸爸一定会把账要回来，风风光光送她去上大学。	坚持	凑合	1
也恳请银行，推销信用卡前先考察一下对方有无还款能力，免得再发生这样“株连”父母及亲属的事情。	推销|考察	发生	1
女婴出生第2天被医院挂错水女儿出生4个多月来，南京市民戴先生的心一直悬着——女儿刚出生就患有囊肿，第二天在南京一家医院治疗时，竟被医院挂错水。	患有	治疗	1
据工厂保安介绍，该名自残男子与公司领导谭先生发生了激烈争吵，见争吵没有结果，方先生便拿起一瓶天那水往身上淋，然后用打火机点着衣服。	拿起	点着	1
街道孕龄检查意外发现“代孕妈妈”昨日下午，记者再次来到在检查中首先发现“代孕妈妈”的京溪街云景社区居委会，居委会罗主任向记者介绍，因为他们社区范围较大，整个辖区内存在大量出租屋，流动人员相对较多。	发现	发现|存在	1
最极端的事情是3年前某产煤大省发生的煤老板被杀案，姚先生说：“这起案件我们业内都说是罪犯买通了煤老板辞退的前私人保安，通过电话确定老板在办公室的时间，然后上门杀人谋财”。	买通	确定	1
达夫夫妇的死讯传出之后，在英国国内引发巨大争议，因为他们是英国历史上第一对双双赴瑞士“成功”接受安乐死的夫妇。	传出	引发|接受	1
市民算命被告知有血光之灾致心脏病复发晨报讯(记者杨雪)先是说中过去遇到的灾祸，再预知所谓的未来。	算命|告知	预知	1
第一节：双手用力在胸前合十并向上，到头顶后两边打开，再由两边向胸部合拢，向左四拍后再回到胸前四拍，然后再向右四拍回到中间后放下。	合十	合拢	1
路人邹先生目睹了两名陌生男子作案的全过程，事发前一辆白色面包车停在档口前2米多高的围墙外，随后从车内下来一名穿白衬衣、黑裤子的男子，手提几个啤酒瓶，放在地上用打火机点燃，随后向围墙内扔去，然后就迅速上车离开了。	目睹	停在|下来|离开	1
先是向仓库内打入大量白色泡沫液体，再用沙袋将仓库所有的通风口进行密封，仓库缺氧，大火燃烧17小时后“窒息”。	打入	密封	1
后根据预约日期，杨某先后在该院进行了11次孕期检查，其中进行了彩超诊断三次，检查记录均未提示胎儿有畸形显示，但负责第二次彩超检查人员无执业医师资格。	进行	进行|提示	1
7月4日，他从镇上乘坐事先联系的客车，下午到达南京市江宁，然后打电话给张满。	乘坐	到达	1
2005年5月，浙江农民蔡开平先后利用假身份证在北京低价收购面临倒闭的公司，然后以这些公司的身份向国税部门申请增值税专用发票，再以5%的税率将发票卖给其他公司，从中赚取利润。	利用|收购	申请	1
沙某到了景洪后先找了家小旅馆安顿下来，然后取回自己没油还停在路边的摩托车。	到了景洪后找了家小旅馆安顿|安顿	取回	1
此时，犯罪嫌疑人已经回到车上，小王速度也很快，跑到小车前方10米拦住小车去路，大叫“我是警察，下车接受调查”，但驾车犯罪嫌疑人不顾命令发动小车，小王对天鸣枪警告，犯罪嫌疑人还是驾车向小王撞来，小王先对着小车开枪，打中小车左边轮胎，嫌疑人继续加速，打算撞倒小王后逃离，小王面对高速驶来的小车一边躲避一边再开两枪，小车驶出十多米后停了下来。	开枪	加速|撞倒|躲避	1
然而胜诉后，学校虽重新接纳了他，但3个月后又将他再次辞退；省教育厅则先是受理申诉，后又称无权处理。	接纳	辞退|受理	1
由于他的左手半截无名指无法找到，医生只好决定先为他修复断指伤口，然后再为他安装一根硅胶做的假指，从而让他恢复正常生活。	修复	安装	1
为了检验自己的想法是否可行，孟晓丽先买来新鲜奇异果，对水果进行清洗、晾干等处理，最后在经过严格消毒处理的容器内放入果肉、冰糖，按比例放入适当的粮食酒、酵母，密封好，经过40天左右之后，再加入麦芽糖，储藏一段时间果子酒就酿成了。	买来	进行|清洗、晾干等处理，最后在经过严格消毒处理的容器内放入|放入	1
当臭味出现后，“闻臭师”首先将空气样本从现场采集回来，然后用“三点比较式嗅袋法”进行判断——样本以纯净空气适当稀释后，置于三个嗅袋中的一个，另两个嗅袋仍装纯净空气，随后由6名“闻臭师”分别以嗅觉判断哪个嗅袋中含有臭气即试样气体。	采集	判断|稀释	1
荷塘环卫派出30多名工人对污染路段进行清洗，他们先用洒水车冲洗路面，然后洒上洗衣粉和碱，再用扫帚清扫路面。	冲洗	洒上	1
网友“deyinglove”告诉记者，第一次看见那位阿姨时，怀疑她不是环卫工人，只是来帮忙扫地的，可之后接二连三地看见她，于是就觉得她很特别。	看见	帮忙扫地的，可接二连三地看见|看见	1
中山市西区环境服务有限公司的一名工作人员表示，为环卫工人自身的安全着想，他们也严格要求自己的工人工作时穿上统一的环卫服，如有工人违法规定，他们一般会先口头警告，再犯的话就要扣钱，“5~10元一次”。	警告	扣钱	1
赵先生成功地阻止了小偷犯罪，然而接下来发生的事情，却大大出乎他的意料。	阻止	发生	1
“那个小偷很生气，他先是狠狠瞪了我一眼，然后就向马路对面招手。”	瞪	招手	1
七旬老父欲再婚 其子扣户口簿阻拦晨报讯(记者 王歧丰)昨天，丰台区长辛店镇辛庄村，年届七旬的勾先生仍在自家的水暖厂内忙碌着。	再婚其子扣户口簿阻拦|阻拦	忙碌	1
医院以没床位为由拒收病人致男孩睾丸切除据新华社电 （向前 林炜）有媒体19日、20日报道了温州医学院附属第一医院、附属第二医院拒收导致男孩一侧睾丸被切除的事件后，浙江省卫生厅高度重视，3月20日晚，浙江省卫生厅派出专门人员及泌尿外科专家到温州展开调查。	拒收	拒收	1
在第一次将丈夫毒倒送昆明抢救回转后，许梅再次向丈夫下毒，因药量重，狗吃了老宋的呕吐物当场死亡。	抢救	下毒	1
当年8月18日，张先生被授权在甘肃省庆阳市特许经营，第二天张先生再次支付该公司各项费用18800元。	授权	支付	1
3月23日，湖南长沙的易先生致电荆楚网称，其母亲肖女士在湖南中医药大学第二附属医院住院期间，因该院员工工作失误而被摔死，院方却隐瞒真相欺骗死者家人。	致电	住院	1
死者家属：母亲因院方员工失误摔死易先生介绍，其母肖女士在2008年12月16日买菜时遭遇车祸被撞伤左腿，家人将其就近送往了湖南中医药大学第二附属医院十一病室救治。	摔死	买菜|遭遇|送往|救治	1
对方于是先给了他1800元定金，答应事成之后，再另付一笔酬金。	给了	答应	1
据李某回忆，迟疑了半个小时后，他从橱柜里取出了铁锤和菜刀，先用铁锤砸碎了小明身上的关节和骨头，再用菜刀将小明的四肢分解下来，后来又将小明的每一块尸骨切割成小块，装到了20个塑料袋里。	砸碎	分解	1
表哥为了能尽快帮小慧治病，几天前到镇上准备贷款，没贷到，原因是他去世的父亲还没有销户，需先到派出所将父亲的户口注销、再把他妻子的户口从娘家转过来才能贷款，而且最多只能贷3000元。	注销	贷款	1
途中，赵先生发现包里的东西快掉到地上，停下脚步整理袋子，紧接着两人吃了一惊。	发现	整理	1
蔡先生说：“周彦宏是在一次晚会上与林浩认识的，之后一直默默帮助他。	认识	帮助	1
检察官说，“他说他当时的目的是先劫持旅客，然后冲过安检通道上飞机，最后控制住飞机，再提出要1亿元赎金。”	劫持	冲过	1
检察官说，“他说他当时的目的是先劫持旅客，然后冲过安检通道上飞机，最后控制住飞机，再提出要1亿元赎金。”	劫持	冲过	1
诈骗团伙伪造信用卡套现90余万元(图)本报讯（记者刘杰）1人主谋7人联手，先让酒店收银员盗取客人信用卡信息，制造假卡，然后和商家联络好，在POS机上肆意刷卡套现90余万元。	盗取	制造|联络	1
警方决定先“付”一部分现金稳住绑匪，确保孩子的生命安全，然后再伺机将其一网打尽。	稳住	打尽	1
刘凯峰琢磨了好长时间，因为情况比较特殊，最后决定先帮助老两口办理城市户口，然后再帮助他们申请低保。	帮助|办理	申请	1
周先生说，根据现场的情况，他分析小偷第一次是割开窗户防盗铁条进入厂内，作案后更换了门锁，然后像主人一样，分多次进屋盗窃。	割开|进入	更换	1
再次主持调解未果后，崔某应当事人的请求而清查王某和魏某的共同财产，其间吃了原告吃被告，先后收下王某送来的现金3000元和魏某的现金1000元，并5次接受魏某及其亲属的吃请。	主持	清查|收下|接受	1
审讯中闵阿麦奴交代，当撞倒第一个女生的时候，他也想停车查看，但想到自己不但是酒后驾车，而且还没有驾照，便加速逃离现场，谁知又撞上了第二个女生。	撞倒	停车查看|逃离|撞上	1
而医疗部负责人表示，让丁小姐先回家观察十天，处女膜伤口也许会自行修复，如果不能修复再来谈。	观察	修复	1
男子3年捡拾北京郊区抗日战役千余残片(图)在一次登山中，家住昌平的杨国庆先生偶然发现了保存较为完好的战壕，之后开始就捡拾战争碎片，他认为应该有人记住这段历史——昌平区南口战役。	发现	捡拾	1
但经过多轮筛选之后，先天畸形的玛丽琳却不可思议地成功闯入了决赛，成为最后50名争夺冠军头衔的佳丽之一！	筛选	闯入	1
失主要求“关门抓贼”左先生告诉记者，昨日，自己在该酒楼给孩子办10岁生日宴，中午就餐之后与家人到吧台查看晚餐菜单，正在排队时，突然感觉被人撞了一下，随即发现裤兜里面装有3000余元现金的钱包被盗。	要求	办10岁生日宴，中午就餐与家人到吧台查看|查看	1
为了打消记者的疑虑，他又补充道：“你可以先验货，确定是真枪了再付钱。	验货	确定是真枪了付钱	1
今年3月中旬，她和王先生结婚，之后遭到曹某几次骚扰。	结婚	骚扰	1
"这个最初只在福州某社区网站挂出的帖子，因为噱头有看点，第二天就被天涯、新浪论坛转载，另外该帖主人，薛先生帖子中还说，每天只安排3位看房者。	转载	安排	1
"这个最初只在福州某社区网站挂出的帖子，因为噱头有看点，第二天就被天涯、新浪论坛转载，另外该帖主人，薛先生帖子中还说，每天只安排3位看房者。	转载	安排	1
他先按下了“201”这几个数字，只见在电话机的屏幕上面出现了“免费电话201”的字样，接着他就把折好的锡纸插进电话卡插入口。	按下	出现|插进	1
钟万益等同伙收到12万元人民币、2.8万港元后，为防罪行暴露，用电线勒死李×昌，然后用事先准备好的刀将被害人的尸体肢解成头、四肢和躯干共6块，用黑色塑料袋包裹后装入两个旅行箱，并于当晚将尸块丢弃到花都区东莞村和石塘村等地。	勒死	肢解|装入两个旅行箱，并于当晚将尸块丢弃|丢弃	1
江津区教委对此作出处理：给予杜市中学校长熊天华行政警告处分，对班子成员进行诫勉谈话；给予吴建勇行政警告处分，责令学校免去吴建勇班主任职务，并不再担任该班教学工作；对于杜市中学出现的管理不到位和个别班级收费不规范的现象，责令学校立即进行全面整改，在一个月后向区教委书面报告整改情况，区教委组织专人进行检查验收；责令学校将初二(六)班清洁费在与工人结算后，余额全部清退给学生；责令学校向区教委写出深刻的书面检查，取消学校当年所有评优评先资格。	担任	进行|报告|组织|清退|写出|取消	1
民警首先在电量指针停留处标下记号，由于电动车没有里程表，同时考虑凶手骑车时的天气环境及路况，专案组决定一人骑摩托车跟着电动车以回字形状将电量全部跑完，发现剩余电量可以跑16.5KM，然后将电量充足后再次跑完发现是25KM。	标下	跟着电动车以回字形状将电量全部跑完|跑完	1
据目击者称，当晚8时许，54岁的蒋随卫突然手持撬杠出现在村中道路上，先将一个路过的民工打死，接着又打伤另外3名民工，随后，他闯入邻居柳黑脸家，将柳家4口人全部打倒，然后跑到刘蛋家、董广有家等连伤数人，其中，柳黑脸因伤势严重，在送往医院途中死亡。	打死	打伤	1
“摩的”围堵擒获大巴司机“摩的”司机王先生介绍说，这辆大巴开到沙井街道的洪田路时，放下十几名乘客，然后飞快地开走。	围堵|擒获	开到|放下|开走	1
之后该卖家多次找到何先生，要求将中评修改为好评，何先生未予理会。	找到	修改	1
低调领奖 谢绝外人陪同王先生表示，在问过兑奖程序后，他一直精心收藏着中奖彩票，想等大家忘记这注大奖时再领奖。	领奖	问过|收藏|忘记|领奖	1
破哥立即买来材料，先请焊工在车身上焊接上支架，再用木板搭出靴形，最后蒙上皮革，再涂上特殊的胶水，“这样就可以防雨、防火、防日晒，跟靴子一样耐穿”。	焊接	搭出	1
警务督察被控用购物篮藏镜子偷窥女子裙底中新网4月15日电 据香港《大公报》报道，身为香港警察划艇队体能导师的警务督察，涉嫌于休班期间在葵涌一间超级市场，先将一块预备好的镜片放入购物篮内，再用白毛巾遮掩，其间行近两名身穿短裙女子身后偷窥裙底春光，被受害人察觉通知职员报警。	放入	遮掩	1
厉莉2007年第一次给小颖(化名)捐献造血干细胞后，今年小颖病情再次复发，4月7日，厉莉的血液第二次滴入小颖体内。	捐献	复发	1
投注后，吕先生通过建行网上银行支付给刘某1.5万元，加上此前刘某帮吕先生已兑奖的5000元前期彩票奖金，共同作为此次购买彩票的部分费用，同时约定剩余购彩款在第二天取票时支付。	兑奖	约定剩余购彩款在天取票时支付|支付	1
骗的全是小姐2007年1月23日左右，三人再次行动，并在南京一酒吧结识了小姐阿美，三个人如法炮制，又在宾馆取得了阿美的信任，使阿美将人民币27000元放入他们事先准备的密码箱内，后趁阿美不备之机予以调包，窃得阿美人民币27000元。	行动	结识|取得|窃得	1
舒勇介绍，要完成这件作品，要先将块状的骨灰研磨成为粉末状的灰，再将灰掺进陶土中，然后塑造成“生命之花”的造型，然后通过高温烧制成型。	研磨	掺进	1
浮石替身掉包过关这批废旧物到达南沙港后，刘某青先以浮石为名向南沙海关申请转到萝岗通关，趁这批货物在南沙停留期间，霍某偷偷将货柜拉回事先租用的黄埔文冲某仓库全部换装成浮石，并用事先制好的假关锁封箱后再转往萝岗海关。	拉回|换装	转往	1
11时32分，肖洁华再次接到110指挥中心处警指令，但他仍未及时赶赴现场，而是先吃午饭，直到下午2时，他才到达现场。	接到	赶赴|到达	1
姐弟俩回到家中之后，向倩先是让丹丹去把碗洗了，女儿一声不吭地跑到厨房，洗起碗来，向倩也忙着洗菜。	回到	跑到厨房，洗起碗来，向倩也忙着洗菜|洗菜	1
罗先生已经答应了给欢欢进行尸检解剖，之后会将尸体在广州火化。	答应|进行	火化	1
白云警方接报后，迅速派出精干力量到场处置，处置民警先控制住手举白纸的张×均，再慢慢接近持刀男子张×述与其谈判。	控制	接近|谈判	1
作为一名曾经的刑事犯、一名被原单位开除了公职的刑满释放人员，王安武竟然能顺利地再次回到原单位上班，并先后任县五金公司经理、县商贸总公司副总经理，最后当上县粮食局局长，这其中的故事耐人寻味。	回到	当上	1
作为一名曾经的刑事犯、一名被原单位开除了公职的刑满释放人员，王安武竟然能顺利地再次回到原单位上班，并先后任县五金公司经理、县商贸总公司副总经理，最后当上县粮食局局长，这其中的故事耐人寻味。	回到	当上	1
之后这6个红球号码就没有更换过，蓝球号码还是跟着感觉走，有时实在想不出蓝球号码时，陈成就选择第一天买彩票的日期，以此来永远记住第一次领工资的日子。	更换	选择|记住	1
在南京“考察”了三天才领奖4月9日上午，陈成接到下午要出差的通知，上午11点多正好经过福彩投注站，将之前的号码再次进行了投注，红球没变，蓝球就写了第一次买彩票的日期12和13，当即陈成发觉口袋里正好有8元零钱，于是又进行了2倍投注，共花费了8元。	进行|投注	进行|花费	1
一听朋友有事，他挺身而出，先在网吧里找到一个叫“喷狗队长”（网名）的网友，借了一把尖刀，然后下楼等候对方到来。	找到	等候	1
一听朋友有事，他挺身而出，先在网吧里找到一个叫“喷狗队长”（网名）的网友，借了一把尖刀，然后下楼等候对方到来。	找到	等候	1
记者了解到，由于该案的特殊性，海陵区人民法院在再审的半年多时间内，着重对鲁昕提供给法院的那张欠条的真实性进行了鉴定，先后找到了包括西南政法大学在内的多位专家。	再审	找到	1
第一是孩子不能没有母亲；第二把儿童家园办起来；第三我要生活，要挣钱还债。”	没有	办起	1
伎俩8谎称亲友出事急需用钱不法分子先通过某种途径了解某人手机、家中电话或朋友电话，然后向对方手机不断打电话骚扰，迫使其关掉手机。	谎称|了解	骚扰	1
据悉，“搬家”工人首先动用推土机在房屋地基下2至3米深的地方进行挖掘，挖出一些孔洞再插入一道道钢梁。	动用	插入	1
除了报案的丁丁之外，大部分的女生在第一次被强暴之后并没有声张，一部分甚至在陈伟军等人的引诱下继续担任起“掮客”的角色。	强暴	声张	1
萧金绸先被送往南投医院，因伤势严重，再转往台中中山医院抢救，不过因脑内出血，昨宣告不治。	送往	转往台中中山医院抢救|抢救	1
有轨电车停运3个半小时54路有轨电车车队来了10余人维修线路，首先将线路上的电掐断，然后对双向断落的滑行线路进行维修。	掐断	维修	1
据了解，浙江永嘉县最早为道路交通事故中确需救助的伤员在三家定点医院开通绿色通道，按社保标准进行治疗，并对医疗费先行全额垫付(救治后再行偿还)。	垫付	偿还	1
如果不给钱的话，今天是车明天可就是人了……”对方的话极具威胁性，而且是二人分别给她打来电话，女副厅长也认识到了这件事的严重性，但她并没惊慌，她先用语言稳住二人，“50万不是个小数目，你得给我点儿时间准备一下……”然后借机偷偷地打了报警电话。	稳住	准备	1
谈话中，杨志高特别谈到了博士论文，因时间原因和各种情况，他担心论文通过不了，有些灰心，但是杨先生并没有责怪儿子，还不断鼓励他，“这次通过不了不要紧，下次再来就行了”，父子一直聊到了晚上11点多，杨先生劝儿子早点休息，“不要想得太多”。	责怪	鼓励	1
杨女士当时借着灯光检验了一下，都是货真价实的真币，没等她们缓过神来，男子甩甩手走人了，担心他把钱再都扬了，或给了其他人，而人家再不还他，于是大家伙一商量，决定先替他收着，等他想起来了再回来拿走。	收着	想起来了回来拿走|拿走	1
今后，他们收到的爱心捐助都将先打入这个账户中，再根据各个患者的需要进行分发。	收到|打入	进行	1
署长杨可归纳了数起抢劫出租车的作案特点：“都是先由一人在成都市区招车，然后前往郊区地点搭乘另一名同伙，在偏僻无人处实施抢劫。	招车	前往|搭乘	1
解廷民建议，不妨先在工作中积累一定的相关行业经验和社会阅历后，有了一定的资本，再来创业，成功的可能性应该会大一些。	积累	有了一定的资本，来创业	1
3个小伙子身上有刀，他们拿出自带的匕首，先是刺伤了沈某的胸部，之后又刺伤了陈某的左手臂。	刺伤	刺伤	1
【同期】山西隰县公安局长 王博君第一路是在所有的出境入口进行设卡堵检，看能不能在第一时间里内把他堵在县域境内；第二路是围绕中心现场认真开展检查、勘察、从中寻找犯罪分子的蛛丝马迹；第三路我们对所有的旅店、网吧能够有外来人员留宿的地方进行大面积的过筛子似的排查。	进行	开展|寻找	1
【同期】山西隰县公安局刑警大队大队长 常虎兰据他们这几个嫌疑人交代他们那天晚上是10点多钟，分别分成两个小组上去步行上了小西天，上了小西天以后，第一个作案是先把那个监控录像那个电线给绞断，然后他们在提前，在作案之前在我们县城里面买了绳索，买了绳索以后就是先有一个人进去，从边上爬进去以后，把剩下的人拿绳索吊上去，掉上去以后拿这个钢筋钳子，把(无量殿)的锁都撬开了，开始作案。	绞断	提前	1
抓获后，杨文杰交代，这次的绑架抢劫已是他第二次进入508房间，几天前第一次进去的时候，没找到钱，他干脆把用得着的零碎物品全部偷走，毛巾、洗衣粉、香皂、卫生纸、被套等，甚至连小张刷碗用的钢丝球，他也来个顺手牵羊。	进入	找到|偷走	1
见到梁先生后，约定先去附近银行取钱，然后可去宾馆开房。	约定|取钱	开房	1
“zaqw”称第一眼看见该男子就留下了深刻印象，“8点多快到厚街时我曾拿出笔和纸写下我的电话号码，握在手心里出汗一直到下车时终究没有勇气递给你，然后看着那车渐渐远去……”除了讲述和同车陌生男子偶遇的经历之外，“zaqw”还在帖子中把自己的QQ号码留下，并且穿上当天曾经穿的衣服拍了2张照片，上传到帖子中，“现在抱着一丝希望在网络上发帖，我在找你，如果看到请联系我。”	看见	快到厚街时我曾拿出|拿出|写下|递给	1
市民竞拍下41辆轿车被索20万元停车费原来车辆停在交通事故停车场 每天停车费20元/辆 竞拍人没对竞买标的细致了解吃了亏60万元拍下41辆小轿车后，取车时被告知要再交20万的停车费，这是市民张先生遇到的离奇事。	再交	遇到	1
小心切割 抬出伤者根据救援方案，首先得将两车分开，然后才能对遇险人员进行施救。	分开	施救	1
此外，法官表示，一般罚金都是支付给亲属的直接受益人，然而在此案中，罚金先由法庭接收，然后再决定应该支付给谁。	接收	支付	1
主管先让每一位用店内新装打扮的女店员对自己的一身装扮作出评价，对自认为“不过关”的先进行一番讨伐，再让别的店员对自认为“过关”的店员的搭配进行评价、提出更好的搭配意见。	讨伐	评价|提出	1
宗逵分析了局势之后，知道有两条路摆在面前，第一是立马抽出，自己把账填上。	分析	知道有两条路摆在面前，是立马抽出|摆在面前，是立马抽出|抽出	1
第二天，该女子再次致电陈先生，一开口便问陈先生有没有收到印刷单，感觉怎样？	致电	收到	1
他用电脑、打印机打印办证人提供的资料，然后加盖私刻的农机管理部门业务印章，先后“办理”机动车牌照、行驶证3369套，并将这些手续卖给他人使用，从中牟取暴利30余万元。	加盖	办理|卖给|牟取	1
他告诉记者，听说敢打这种广告找枪手的警惕性都很高，对方往往会称负责将准考证、身份证等全部造假，只要替考者进入考场考试就先付一部分费用，然后等考试成绩公布后再付一些费用。	进入	公布	1
“5年后，第一批孩子将参加高考”，校方领导说，此时，再启动奖学金鼓励考上大学的学生，并类推2年，直到98名学生结束高中生涯。	参加	鼓励	1
少年频频划伤抢劫单身女子 网上总结作案经验近来，九龙坡区石坪桥冶金村一带，发生多起单身女性被抢的案件，凶悍歹徒让人闻风丧胆，总是先用刀残忍划伤当事人后再实施抢劫。	划伤	实施	1
谭卓的身体被车头撞上后，先是在空中翻转，在撞到挡风玻璃后再度飞了出去。	翻转	撞到	1
1997年，雷女士受邀照顾张氏夫妇，“当时教授老伴卧病在床，本来说先照顾几天，但一直请不到合适的保姆，就再三挽留我。	照顾	请不到合适的保姆，就三挽留	1
记者在现场看到，离撞人处30米开外，可以清晰地看到被中巴车撞倒的路边的一个水泥界碑以及车辙印，路旁两棵树上挂着被撞断的树枝，证明撞碑后，中巴车速度未减，并偏离马路，先将陈明香家堂屋前一根支撑雨篷的泥柱子撞成两截后，又撞了7名等车的人，之后又撞坏她家厨房。	撞成	撞坏	1
半小时后，当张先生准备开车时，发现驾驶室玻璃上有个大洞，再看车内的手提包时已经不翼而飞。	开车	有个大洞，看车内的手提包时已经不翼而飞|不翼而飞	1
但他也深知这样做的后果，在他犹豫了一个月后，最终在欲望的冲动下，利用这家银行的漏洞，编设程序，再次非法侵入银行的网络服务器，在获取部分银行客户信息后，于2006年5月23日，在网吧内，假冒“王冰”的名字，在该银行开设借记卡账户，并于同年5月24日至5月28日间，先后通过该银行转账系统，将客户肖某、徐某、杜某账户内存款共59.9万元划入“王冰”的账户内。	侵入	获取|开设	1
母亲携5岁女儿跳下14楼致1死1伤(图)本报东莞讯 记者唐波报道：昨天上午8时许，东莞莞城区东湖花园小区内发生一起骇人命案，先是一名5岁小女孩从14楼摔下，紧接着其母亲也纵身跳下。	摔下	跳下	1
目击者：女跌倒后胸中3刀一直在福田口岸计程车站附近摆水果摊档的谢小姐表示，当时看到一男一女两人向自己的摊位跑来，第一反应就是立即躲避，她说：“当时一个身穿牛仔裤及黄色休闲服的年轻女子大喊救命，左手臂流着血，从福田口岸出入境大厅3号门往自己这个方向跑过来，只见身后一男子手持利刀紧追不舍，其间女子似乎因过度惊慌，在横过斑马线时跌倒地上，男子立即压坐女子大腿上，持刀便对准女子胸口狠狠捅下去，连续3刀，然后再畏罪自刺喉咙企图自杀。”	躲避	大喊|跑过来，只见身后一男子手持|手持|跌倒|压坐	1
一直在福田口岸的士站附近摆水果摊档的谢小姐表示，当时看到一男一女两人向自己的摊位跑来，第一反应就是立即躲避，她说：“当时一个身穿牛仔裤及黄色休闲服的年轻女子大喊救命，左手臂流着血，从福田口岸出入境大厅3号门往自己这个方向跑过来，只见身后一男子手持利刀紧追不舍，其间女子似乎因过度惊慌，在横过斑马线时跌倒地上，男子立即压坐女子大腿上，持刀便对准女子胸口狠狠捅下去，连续3刀，然后再畏罪自刺喉咙企图自杀。”	躲避	大喊|跑过来，只见身后一男子手持|手持|跌倒|压坐	1
如果赃物没来得及转手被抓，男聋哑人先要护住头部和裆部，女性聋哑人要护住头部和小腹部，然后蹲在地上，不要乱动，“一般人看是聋哑人，出口气也就不管了。”	护住	护住	1
记者：据承办此案的北京市检察院第二分院检察官说，1993年的时候，于小兰花担任了第一清洁车辆厂的财务科长，此时唐某是车辆长的厂长，于小兰在执掌财政权之后，就成了唐某得力的大管家，两人在1999年向有关单位申请了200万元的购房款，还从下属公司提取38万元的公款，两人用200多万元的公款在朝阳区买了三套住房，一套落在唐某的妻子名下，另一套归了于小兰，这两个人从这个时候起来就有合伙挪用公款的现象。	担任	执掌	1
多年来，第一清洁车辆厂及下属的企业的经营收入都被企业单独设立的小金库，后来第一清洁车辆厂更名为一青环卫工程集团之后，于小兰出任了公司的总会计师。	设立	更名	1
男子假冒大款屡屡骗色 拍裸照敲诈女青年以招聘公关先生为诱饵骗取钱财的骗术早已老套，南京一男青年对此骗术进行了创新，他在网上发帖聘公关小姐，称可以介绍女青年认识成功男士，然后以“过来人”的身份暗示那些想“走捷径”的女孩，要陪成功男士睡一觉以获得信任。	假冒|骗色拍裸照敲诈|敲诈|骗取	创新|发帖|介绍|暗示	1
郭先生被这些电话骚扰得心神不宁，之后他在网上发现自己的个人资料包括住址都被网友搜索了出来！	骚扰	发现|搜索	1
值班医生让婷婷先输液，不要进食，等下午6点左右再拍个片，看看如何手术。	输液	进食	1
小偷见情势不妙，“前倨而后恭”，试图与张先生和众市民“沟通”，提出“交换条件”，“他答应我只要不报警，不但会找回我的包，另外还会再给我300元精神损失费。”	沟通	提出|答应|找回	1
okeoke：如果要帮忙就先拉路旁的人来见证，再去帮忙。	帮忙就拉路旁的人来见证|见证	帮忙	1
这时，郭建军等人就会要求对方先汇一笔手续费过来，如果对方汇了，他们就顺势让机主与公司“王主任”或“刘主任”联系，随后再以收取公证费、银行手续费等名义继续骗钱，直到对方怀疑后不再汇钱为止。	要求	联系|骗钱	1
结果，乌鸦先找来短树枝把长树枝拨到盒子外面，然后利用长树枝挑出肉。	找来	挑出	1
他说，他探索出一条崭新思路，先确定两个最新论点，再创造独特论据，从而解开了“哥德巴赫猜想”这一古老数学之谜。	确定	创造	1
超模冠军签约6年据了解，目前邹林颖和成都一家文化公司签下了长达6年的合约，该公司表示，考虑到邹林颖目前的特殊情况，首先要让她完成学业，然后再将她打造成成都最有分量的超模，同时尽量减少邹林颖的商业走秀活动，多鼓励她参加一些社会慈善和公益活动。	完成	打造	1
所有的费用将分5次支付：双方签订合同时支付5000元、第一次赴香港产检时支付5.8万元服务费(其中4万港元由医院收取)、产前入住医院支付1.3万元、领取证件时再分别支付3000元和1000元。	签订|支付|支付|收取|支付|领取	支付	1
中奖之后，他并没有闲着，一个多月以来，陈先生马不停蹄地做着好事，实践了自己兑奖时的庄重承诺。	中奖	实践	1
 家中开毒厂购买半成品再进行加工当晚，市公安局禁毒总队民警分三路，将李先才、刘正权等6名团伙成员抓获，并收缴冰毒片剂150粒，另一嫌疑人许超也落网。	购买	抓获|收缴|落网	1
马先生说，当时他和朋友在旅社的花坛里小便，老板发现后先是大骂，然后叫了六七个人追砍，“我朋友当时就跑掉了，我比较胖，跑不动，被他们砍伤了。”	发现	叫了六七个人追砍|追砍	1
民警当即现身先将李抓获，再驾车追捕陈。	现身|抓获	追捕	1
为了让褚峰搬走，丁梅在第一份协议中承诺支付给褚峰40万元；紧接着第二天两人又签订了第二份协议，价格涨到了60万元。	支付	签订	1
民警在检查手枪后惊出了一身冷汗：这名男子在打出第一枪后，接下来第二颗子弹根本未射出，而是卡在枪膛里，余下的6发子弹当然也就没机会射出了，这才是导致该男子没继续开枪射击的真正原因，否则，后果真是不堪设想。	打出	射出	1
“首先是程序不合法，警方在抓捕过程中，没有首先亮明身份，也未进行相关询问；其次是，在抓捕过程中致人受伤，存在暴力执法的嫌疑；再者，在取证时亦有刑讯逼供的嫌疑。”	亮明	进行	1
持卡人眼看还款日要到了而没有充裕资金，套现者会用自己的卡或他人的卡套出现金先代为还上，而后再用持卡人的卡套现。	套出|还上	套现	1
周日，医院里隐蔽的监控摄像机拍下了麦克唐纳德令人瞠目的罪行：她从纸巾中取出事先准备好的粪便，然后注入女儿的血管里。	取出	注入	1
警方经侦查发现，在陈先生到银行ATM机查询资金到账情况的前一个小时，一嫌犯在这台ATM机上安装了一个盗码装置，之后，陈先生卡查询时，密码被窥取，银行卡被复制，而后存款被盗取。	查询	安装	1
■被人扯进厕所进行殴打然而令人没有想到的是，距小路第一次被同学殴打一个多月之后，小路在校园内再一次遭遇不幸。	殴打	遭遇	1
收养“私生女”被骗7万多2008年9月，江苏省南通市民李某买了一份名为“天下军事”街头小报，报纸上有一则广告：“跨国公司女老板，因我女儿不争气，产下一私生女，为顾及颜面，求助异地好心人收养，如满意，一次性付300万人民币作为抚养费……”李某被这则广告吸引，先后13次打入“中介”账户7.5万元人民币“保证金”，至2009年初，李某发现自己被骗之后，到大连市公安局报案。	打入	发现	1
昨天早上8:30，常先生乘坐的2号线列车抵达科技馆站后，门一打开，后面几节车厢的乘客如潮水般地涌出车厢，往站台上跑，每个人都神情紧张，“我在第二节车厢，看到人们往外跑，赶紧跟着跑了出去。	抵达	涌出	1
6月7日上午，绑匪再次发来短信，要求苏先生将赎金提高到4000元，但奇怪的是，无论苏先生如何拨打电话，绑匪始终不肯接听，仅通过短信催促他尽快准备赎金。	发来	提高|拨打|接听|准备	1
他先后跑了江苏、河南、湖南、安徽共50个救助站，起初的经历非常刺激，到救助站报个地方就拿票，用试剂将票上的印章洗掉，再到火车站退票或倒卖，钱就轻松到手了。	后跑	洗掉，到火车站退票或倒卖|倒卖	1
为不影响该学生参加高考，学校的意见是先让他参加高考，考完后再调查、协商。	参加	协商	1
年龄最小的江海豹负责关门、把风，由于店主王振国的妻子激烈反抗，由张洪忠先将店主的妻子杀死，然后由陈晓伟将王振国的岳母杀害，接着4人准备逼问王振国银行存折的密码，但王振国说存折密码只有其妻子知道，最后王振国被陈红圆杀害。	杀死	杀害	1
■起诉学校索赔7万余元据小华的母亲介绍，儿子住院期间花费的4000多元钱都是他们先期垫付的，之后学校送来了3000元钱，并由保险公司赔偿了3000多元钱。	住院期间花费|花费|垫付	送来	1
该道口有3条轨道，正当姜师傅驾车经过第一条轨道时：“对面有辆摩托车加速蹿了过来，同时从我身后传来一声惊叫，我刹车回头看了一下，等我再回过头来时，3节没有车头牵引的车厢刚刚从我面前经过，离我车子的前轮不过几厘米的距离。”	驾车|经过	传来	1
网帖：哲学硕士考上文秘职位这则“不符合2009年上半年北京市公务员考试相关职位报名条件的考生居然顺利参加公务员考试还考了本职位第一名”的帖子，由网友“so crazy”于5月28日发表于猫扑论坛，之后被多个网站论坛转载。	考上|参加	发表|转载	1
当然，如果杨先生等人被殴打过程中，火锅店未能尽到劝阻，报警等应有的义务，就应该垫付赔偿杨先生等人损失，以后再向肇事方追偿。	垫付	追偿	1
今年1月8日晚上11点，4人又来到台州，将陈先生车的后窗玻璃敲破，利用解码器发动轿车，再改换车牌，开到温州。	敲破	发动|改换	1
经审讯，谢明刚(男，39岁，贵州遵义市凤冈县人)交代了其自今年5月份以来，从东莞的工厂物色对象，然后将她们先后骗到广宁县城，控制其人身自由，实施强奸并强迫她们卖淫的犯罪事实。	物色	控制|实施|强迫	1
2007年高考前，拿到作弊器后，由李某事先在考场的暖气片后隐藏一套，再由刘某随身带入考场1套。	隐藏	带入	1
对于记者的到来，小荷的奶奶很是紧张，再三核实记者的身份和来意之后，老人的第一句话竟然是：“我老了，发生这样的事情，我的心里很难受啊！”	核实	发生	1
而在“张某骚扰事件”中，被张某骚扰过的2位女性中，第一位虽然接受了调查取证，但也不愿作证，后来在其男友的坚决支持下到派出所进行作证；第二位一开始也因“不好意思”而拒绝作证，但后来总算被民警说服了。	接受	进行	1
愤怒之下胡某于当日晚8时许，从母亲家的堂屋门东边的窗户爬到屋内，先是用打火机点着了床上的被子及衣柜里的衣服，接着又点着了西屋里的塑料薄膜，随后又将母亲、继父家房屋内的全部财产焚烧并危及邻居。	点着	点着	1
愤怒之下胡某于当日晚8时许，从母亲家的堂屋门东边的窗户爬到屋内，先是用打火机点着了床上的被子及衣柜里的衣服，接着又点着了西屋里的塑料薄膜，随后又将母亲、继父家房屋内的全部财产焚烧并危及邻居。	点着	点着	1
据病人家属回忆，刘克田的第一次手术从5月3日下午的4点半一直进行到晚上11时左右，用了7个多小时，手术刚结束半小时，经过医生检查，病人脑部又出现出血症状，需要马上进行第二次手术，就这样刘克田又被推进了手术室，像上次手术一样，病人家属又根据医生的药方跑来跑去缴费拿药。	进行	结束半小时，经过医生检查，病人脑部又出现|出现|进行	1
主治医生：可能是药房医生睡迷糊了6月12日上午，记者假扮病人亲属，跟随刘克田的弟弟和儿子一同找到了正在门诊室的刘克田的主治医生高某，在简单地询问了几个问题后，刘克田的弟弟从包里拿出了那支过期的麻醉药，想弄明白第二次手术是否因为第一次使用了过期的麻醉药所致，医生否认了家属的说法，但他承认药品的确已经过期，但对于此事，该医生说可能是当时药房里的医生“睡迷糊了”。	拿出	否认	1
称，即便她无意间了解到员工说公司的坏话，也会先留意他为什么会这样说，之后再决定怎么去解决这件事。	留意	解决	1
据医生介绍，医院先为其输液，然后赶紧采取右手切开减压术，让淤血流出来，避免肢体坏死。	输液	采取	1
同一天下发‘行政处罚事先告知书’和‘行政处罚决定书’，第二天就强行拆除，程序合法吗？”	下发	拆除	1
两人首先逃到了邻近的鹤山，两人觉得小遥很乖，不忍心杀掉，但又怕送人之后会事情败露。	逃到	觉得小遥很乖，不忍心杀掉|杀掉	1
公诉机关第一次起诉时，就应该证据充足，而不是当辩护律师提出新观点后，再去让公安机关补充侦查。”	起诉	提出|补充	1
两人进了大卧室，为预防母亲报警，小娟先拔掉电话线，然后在家中找到一把长约30公分的单刃刀交给小磊，并让小磊躲在大卧室门口。	拔掉	找到	1
她除了将少量非法存款用于投资外，还将其余部分直接借给卢某（另案处理）买卖外汇，或者先向他人购买外汇再转卖卢某，从中赚取利息和差价。	购买	转卖	1
老大带8人围堵查报站由于没有交通工具，后来抓到的吕某某两人，再加上之前抓获的刘某某，对于这3名嫌疑人，便衣民警决定先将他们带至附近的查报站，等待刑警大队及城中派出所带人回单位审查。	抓获	带至附近的查报站，等待刑警大队及城中派出所带人回单位审查	1
但是，保安起身后又追赶上来，再次抓住王先生。	起身后又追赶|追赶	抓住	1
据黄医生介绍，先天性肠闭锁会在孩子摄取了一定的水分之后才会表现出来，通常是在孩子出生48小时左右显现症状。	摄取	表现	1
庆幸的是孩子的生命在维持了9天之后终于有救了，但是东莞曙光光华医院争取来的这次挽救生命的机会，却被一些同行视为开启了一个不太好的先例，因为他们认为这是医务人员面对患者家属的一次非正常妥协。	维持	争取	1
他先在万盛高速路口附近加油站买来汽油，同月20日上午，他又到万盛区购买农药，准备火烧派出所之后再自杀。	买来	购买|火烧	1
民警经审查得知，四名犯罪嫌疑人先是采取网络聊天交友的方式，骗取受害人信息，然后以游玩、找工作为由将其骗至白云湖镇某酒店，强迫受害人卖淫，并对受害人实施强奸。	采取	骗至	1
眼看着人影冲到船的前面去了，他们开着船快速绕到前面去，首先将六、七岁大的小女孩从湍急的江水里救起，接着将中年妇女救起。	救起	救起	1
他们告诉方鸣，深圳先发展起来了，接着浦东发展起来了，这次轮到广西这边了，靠的就是他们这种生意，“这可是人一生中仅有的一次机会”。	发展|起来	发展	1
大约在6月9日，她们先后到新市派出所及惠州龙门铁岗派出所报案，许某当时也曾接受警方调查，但之后便被放走了。	报案	接受|放走	1
大约在6月9日，她们先后到新市派出所及惠州龙门铁岗派出所报案，许某当时也曾接受警方调查，但之后便被放走了。	报案	接受|放走	1
“银行最后答应先垫付，与受害客户签订承诺书，大意是等破案后，根据责任划分再定责。”	答应	签订	1
韩甫政说，此案判决生效或终审后，最好由法院一并进行善后处理，“首先要对投资人等的投资进行核实登记，其次要对所有涉案资产予以追缴清理，然后对涉案财产依法进行处置。”	核实	追缴清理，对涉案财产依法进行处置|处置	1
王先生说：“既然养老院认为母亲太闹没法管理，应该坚决表示不收此类老人，可在我们打算把老人接回来时，却又说可能是老人刚来不习惯，再呆几天适应就好了，一直到6月23日，又通知我们说没法看管，让老人离开养老院。”	认为|管理	表示|接回来时，却又说可能是老人刚来不习惯，呆几天适应|适应	1
此时，车内的人要想出来，必须先拔起车窗内侧的车锁按钮，再拉动开关手柄，才能顺利开门。	拔起	拉动	1
在刘斌的设想中，先把李娟毁容之后自己再吞下硫酸自杀。	毁容	吞下	1
昨日，三峡大学有关负责人接受记者采访时表示，录取周海洋，学校目前考虑了两种思路，一是经省招办特批，直接录入该校本科就读；二是周海洋先报考该校专科专业，进校后再通过“专升本”升为本科。	报考	升为	1
他先是跑出无人看守的第二道大门，直奔餐厅后面的猪圈，通过猪圈的矮墙登上猪舍，然后跃上厨房房顶。	跑出	登上|跃上	1
男子自称因敲错门遭警察殴打 申诉66次仍无果贵州紫云县居民宋庆刚及朋友，因为找人敲错门后与主人发生争执，接下来发生了一连串的事件：出警的110民警成为宋庆刚指控的“打人者”；司法鉴定机构鉴定宋庆刚肠破裂构成重伤；公安机关至今承担着宋庆刚的治疗费用；9个月来宋庆刚先后向有关部门申诉66次；贵州省有关领导对此案作出批示；我国法律规定，重伤害为公诉案件，但公安机关至今未予以立案……	发生	出警的110民警成为|成为|鉴定|承担|申诉	1
两份伤情鉴定结果宋庆刚均属重伤，但第二次鉴定的几个细微措辞变化，却让作出第一次伤情鉴定的贵州省司法警察医院副院长牟苇三缄其口。	变化	作出	1
对此，紫云县公安局认为，由于警方和被害人对第一次伤情鉴定成因发生分歧，因此公安机关委托进行第二次鉴定，这符合相关法律程序。	发生	进行	1
祖母和儿子16岁好友“坠入爱河”玛丽琳·布蒂吉格和第一任丈夫生有两名儿女——29岁的梅勒妮和27岁杰米，和第二任丈夫盖里生下了5名儿女——现年25岁的戴维尼娅、18岁的普里斯西拉、19岁的马克、14岁的里奇和12岁的盖比，由于她的一些孩子也已生儿育女，所以玛丽琳已经是8个孙儿的祖母。	坠入|生有	生下	1
此外，“现在工作不好找，还不如先把个人问题解决了，然后再轻装上阵去拼搏事业。”	解决	拼搏	1
案发于2006年3月，四被告先后到一“按摩”场所要求服务，当众人进入单位后即露贼相，将3名按摩女郎推倒在客厅梳化上，迫令三女不准乱动并交出身上财物，否则将要她们的命，之后抢去三女的手提电话、钱包现金等，得手后，迅即逃离现场。	要求	进入|推倒|迫令|乱动并交出|交出|抢去	1
潜逃八年再婚当上劳模育有一子为了躲避追逃，宁怀青先在自家后山山洞躲了一天，才乘坐长途汽车来到福州，一般选择在建筑工地干点力气活，干一阵换一个地方。	再婚当上|当上	乘坐|来到	1
    事态突变：开发商提出3天付清房款2016年交房到此，事情或将画上句号，然而接下来发生的事却让杨先生措手不及。	画上	发生	1
就在双方将要签订买卖合同的时侯，开发商东信公司突然向杨先生提出3个额外条件，让双方签约再次陷入了僵局。	提出	陷入	1
随后，杨先生试图向法院提出要求强制执行，得到的结果却是：若要强制执行，需再次向法院提起诉讼。	提出	提起	1
记者在推荐的网站上看到，大多数国内网友一见到这个另类好玩的电影网站首先是赞叹很“潮”，然后就立刻收入到电脑收藏夹，有个叫狐狸的网友说：“这个网站和最权威的IMDB电影网都要被我永久保存，因为太有用了，以后每次去电影院看大片我都要来查下尿尿时间。”	见到	收入	1
记者了解到，赔付标准主要依据国家相关法律规定，赔付资金由江宁区政府先行垫付，条件成熟后再向犯罪人追偿。	垫付	追偿	1
之后他又干起了信用卡代理，和别人一起接过食品安检的活，赚得人生第一桶金。	干起	接过|赚得	1
根据现场地形，专案民警迅速确定了先对张高尚所在的村子形成合围，再展开拉网式搜捕的方案。	确定	展开	1
小美说，昨日上午该公司业务经理温某先在Q Q上和她联系，聊了一些基本情况后知道她是应届生，然后打手机约她面试。	联系	聊了一些基本情况后知道|知道|约她面试|面试	1
第二次记者报明身份进行电话采访时，温某先是多次否认“没有这样的事”、“真的没有”。	报明|进行	否认	1
陈奕启死死将装有相机的包抱在怀中，对方先是一拳打中其头部，接着将他推下人行道，按倒在地。	打中	推下	1
法院审理认为，被告人胡某先后十余次冒充省人大领导，以划拨各种款项为由诈骗钱财，流窜作案，社会危害大，实属犯罪情节严重，给国家机关及其工作人员的工作造成极坏影响，其行为触犯《中华人民共和国刑法》第二百七十九条之规定，已构成招摇撞骗罪，依法判处胡某有期徒刑三年六个月。	冒充	划拨|诈骗	1
下午1点20分，经过协商，王先生让人撕去了店外的两张宣传页，并承诺不再使用此类消费券，聚集的歌迷这才离开，临走让店主不要再贴了。	撕去	使用	1
据王瑛交代，自从骗了刘飞第一笔钱后，她和男友就不再外出工作，租房子、吃穿等花的全是刘飞的钱。	骗了	外出	1
在当时法庭上，番禺检察院公诉人如此勾勒出郭永强案之脉络：首先“以有关单位催款的名义，持仿造的单位催款文件领出支票”，然后再将其“交给了与其有业务往来的梁某”，再由“梁某转交给开平的关某套现”，之后将“套现的一部分现金归还给郭用来还梁的欠款”，“余款付给郭永强”。	催款	领出	1
面对飞来横财，夫妻俩再次选择了报警，经查这是入室小偷先前在小区其他人家偷的，在被这对勇敢夫妻制服时将赃物藏到沙发垫子下。	选择了报警|报警	制服|藏到	1
张杰先将二轮摩托车推至文化岗暂时扣留，然后把摩托车上的3人请进文化岗内。	推至文化岗暂时扣留|扣留	请进	1
网帖曝法院不知作案时间情况下判定强奸罪(图)现代版“葫芦僧乱判葫芦案”：第一，犯罪的时间居然是“2008年二三月份的一天”，最基本的作案时间都不清楚；第二，介绍卖淫的人构成“介绍卖淫罪”，嫖娼的人却构成“强奸罪”；第三，起诉定性是“轮奸”，最低应判处10年以上有期徒刑，可被告却被判5年，是“量刑畸轻”了。	判定	犯罪	1
字最先在台湾的BBS社群上开始流行，随后来到中国大陆，然后传入香港。	流行	来到|传入	1
于是，无力偿还的李丽向陆、孙二人伸手借钱——第一笔1万元，用于偿还手续费；第二笔1.5万元，用于偿还上一笔的利息；第三笔2.5万元，用于应付父母查对账户……	伸手|借钱	偿还	1
接到电话后，于红这才有点后怕，而同屋的女孩急中生智，让她先谎称洗澡，假装答应，然后去报警。	谎称	答应，去报警	1
“第一我们不接受采访，第二目前事情还在调查中。	接受	调查	1
无奈之下，王某再次卖淫，先后5天共交给唐某1300元。	卖淫	交给	1
每天吃饭之前，他们要先排队，进入餐厅后要安静地坐下，然后双手合十，念诵“感谢父母赐给我生命，感谢老师给我智慧”等祝福的话语，念诵完毕，等待老师夹第一筷子，孩子们才能开始吃饭。	排队	进入|坐下	1
于海泉先后8次挪用公司商业银行账户公款6753万元，打到这个秘密账户，然后办理通知存款业务。	挪用	办理	1
14日凌晨1时许，双方达成初步意见：由陈某先赔偿家属5万元，然后将尸体运到火葬场冰冻，待善后工作处理清楚后再火化。	赔偿	运到火葬场冰冻|冰冻	1
“进去以后，皮带、戒指、打火机什么都被收走了，他们叫我先进去，说以后再慢慢调查。”	进去	调查	1
“进去以后，皮带、戒指、打火机什么都被收走了，他们叫我先进去，说以后再慢慢调查。”	进去	调查	1
妹妹死后被诊为药物中毒 姐姐以身试药推翻结论黑龙江省嫩江县女子代力，在胞妹代义离奇死亡之后，面对司法机关“药物中毒死亡”的鉴定结论，不惜“以身试药”，并最终换得一次“阳光”鉴定，推翻了先前的鉴定结论。	死亡	换得|推翻	1
袁先生称：“要想根治这个问题，最好还是将那些准备开卖旅游品的店，交给当地的旅游局审核把把关，再让他们经营。”	根治	开卖|经营	1
经查，今年16岁的苟某是陇县人，先后6次以修车的名义，先后盗走厂里的机油、暖风开关、刹车片等汽车配件30余件，然后再倒手卖给了几名出租车司机进行获利。	盗走	卖给	1
经查，今年16岁的苟某是陇县人，先后6次以修车的名义，先后盗走厂里的机油、暖风开关、刹车片等汽车配件30余件，然后再倒手卖给了几名出租车司机进行获利。	盗走	卖给	1
选举时间有出入结果未变化7月20日，当记者再次向陈文学了解事件进展时，他向记者透露，直到17日晚上，村支书、村主任和村治保主任才连夜组织了30多名群众代表重新投票，重新选出了2名低保户，其结果正如低保中心工作人员所说的，还是先前抓阄选出的2位村民。	了解	组织|选出	1
警方破获建筑老板遭绑架勒索案“第一不准报警；第二不准告诉任何人。	破获	告诉	1
尽管“200000000元巨款”在刘先生的账户上存在了20多个小时，但他战胜了自己，再没有动提现的念头。	存在	战胜	1
调查想当“陪游”先得发送照片根据小杜的描述，记者登陆了该求职网，逐条搜索之后，记者发现该网站所发布的招聘信息中，不乏招聘“商务陪游”、“高级生活助理”之类意思隐晦、月薪过万的职位，均要求“形象气质佳，大方热情，有意者先发送照片”。	发送	登陆	1
Cindy说，因第一次手术没做好，夫妻俩还要等待Cindy第二次手术再启动下一行程。	做好	等待|启动	1
调查想当“陪游”先得发送照片根据小杜的描述，记者登陆了该求职网，逐条搜索之后，记者发现该网站所发布的招聘信息中，不乏招聘“商务陪游”、“高级生活助理”之类意思隐晦、月薪过万的职位，均要求“形象气质佳，大方热情，有意者先发送照片”。	发送	登陆	1
 他告诉记者，虽然开发商在此之前多次找他们协商，但拆迁补偿很不合理，“第一次只愿补偿65万元，虽然第二次提高到130万，但过渡期长达36个月，现在衡阳商品房均价每平方米2000多元，我家建筑面积是1080平方米，又位于马路边上，商业开发价值远不止这些。”	补偿	提高	1
俄罗斯女博士生为写医学论文斧劈两邻居据英国媒体23日报道，俄罗斯新西伯利亚市24岁女医学博士生塔蒂娅娜日前为了撰写详细专业的关于死亡的医学论文，竟然先后用斧子残忍劈死了两名年过八旬的女邻居，然后坐在垂死的受害者身旁仔细观察和研究她们的死亡过程。	劈死	研究	1
陈辉首先假装借用高某的手机，趁高某不注意拿出手机卡，然后称手机没电，高某对此全没在意。	借用	拿出	1
据他们介绍，毕业生签订就业协议的程序是：学校先把就业协议书发放到学生手中，然后由学生去落实就业单位，在毕业生与用人单位两方签字盖章后，院（系、所）和学校毕业生就业部门最后签字盖章，“我们经过比对笔迹，确认赵冬冬的就业协议书是由他的同学李明代签的。	发放	落实	1
体彩店位于邛崃市桑园镇商业街，据老板李凤介绍，7月17日下午，顾客余先生打来电话，要求按照上次购买的号码再购买15注体彩。	打来	购买	1
也有市民认为公交公司应该规定第一次刷卡和第二次刷卡的时间间隔，比如5分钟以后才能刷第二次。	规定	刷次	1
郭琳先走到车驾驶室旁，看见一男子系着安全带睡着了，车内再无其他人。	走到	系着|睡着	1
昨天上午，“辣椒王”李永志在郑州火车站广场再摆擂台，透露准备近期出征湖南、贵州等产辣椒的地方，临行前先在家门口练练手。	再摆|摆	出征	1
去年春节前，工人到荔湾区有关部门请求协调，要求承建方先发给员工60万元工钱回家过春节，余下的97万元过年后再解决，“但到现在也没给”。	发给	解决	1
他们先在经常有冒牌军车出现的地方蹲守，然后锁定该地点经常出入的冒牌军车，掌握其出入规律。	蹲守	锁定	1
刘宗朝先是要求内部集资，接着又向社会上集资。	要求	集资	1
于是二人开始谋划绑架方案，他们想到先由徐某以介绍赌博为由，将夏某引到偏僻处，然后两人联手将夏某绑架。	想到由徐某以介绍|介绍	引到偏僻处，两人联手将夏某绑架|绑架	1
有一个少年犯，他第一次抢劫，竟然是在刚参加了学雷锋活动之后。	抢劫	参加	1
马红军到小鹤、小畅所在的郑州盲聋哑学校了解情况，意外得知，这已是学校一个月内发生的第二起聋哑学生失踪事件，第一起是2008年9月19日失踪的14岁的四年级学生小娇。	发生	失踪	1
第二种是，拆迁户提出具体的补偿金额以后，由钟某制作一个超额的补偿表，在拆迁户领取补偿款之前，先要求拆迁户将超额部分预先交给钟某，再由钟某与拆迁户办理相关的手续。	交给	办理	1
车祸让他成了“植物人”今年1月15日，徐先生在骑摩托车时不幸遇到了一场车祸，之后便进入了深度昏迷。	遇到	进入	1
白云二大队一位民警告诉记者，有可能是骗子首先选好目标车辆，然后在其经常出入的地方拍下车辆行驶的照片后，制作假罚单来诈骗。	选好	出入|拍下	1
四人来到南京之后，先在迈皋桥附近转悠，只偷得了一部手机。	来到	转悠|偷得	1
此后两年时间内，王汉辉在上海浦东发展银行、中国民生银行等6家银行里先后办理了7张信用卡，再次采用同样的方法恶意透支。	办理	恶意透支|透支	1
刘乐在法庭上说，马某给了他两张伪造的经济适用房审批表，他让赵先生填写完毕后，却再也联系不上马某。	填写	联系	1
他说这是应该做的，反倒后来赵先生他们客气得让他很不好意思：“先是往我后备箱里塞满了哈密瓜，接着又塞给我一笔钱。	塞满	塞给	1
①根据其富有程度而定②一枝玫瑰花③999朵玫瑰花④钻戒、lv包或汽车等奢侈品⑤不提任何要求2、假如老公在婚前要求与你同床，在下列哪种情况下，你最可能答应：①双方酒后②你酒后③一起外出旅游住店时④跳舞、唱歌或打牌等娱乐活动后⑤他给你买礼物后3、你认为婚礼的隆重程度会否影响你们以后的生活：①会②不会③不知道4、你发现你的同事买了一件貂皮大衣，这时你会：①把情况告诉老公②心里也想买一件③要求老公买一件送给自己④不在意这件事情5、你很累了，老公回来了，在谁做饭这个问题上，你会：①告诉老公，请老公做饭②自己拖着疲惫的身体去做饭③约请老公一起做饭④只管躺在沙发上6、老公出差很久，你的生活很孤单，你会：①每天和老公煲电话粥②隔三差五和朋友们吃饭、聚餐、唱歌、跳舞、打牌③常去父母或公婆那儿解闷④自己带着孩子在家闷着7、在你个人工作上或自己的事情上遇到了难处，你首先会想到：①告诉老公，请他帮忙②告诉领导，请他帮忙③告诉同事，请他帮忙④告诉朋友，请他帮忙⑤谁都不找，自己解决，解决不了就不做了8、你和老公吵架了，你会：①不理他，自己玩②离家出走，等着他打电话③主动和老公和好④去和别人诉说委屈⑤找公婆或父母告状9、你发现老公的手机上有一条女性发来的暧昧短信，你会：①让老公说出这个人是谁，并解释为什么会发这样的短信②装作不知道，但在心里记着③不管他，爱谁谁④逼着老公马上打电话，弄清事实⑤认定老公有外遇，与他大闹10、你自己的嗜好是：①看电视②打毛线③吃瓜子④看书⑤逛街购物⑥抽烟喝酒⑦许多种11、假如老公反对你喝酒或抽烟，你会：①不再抽烟喝酒②表面上说改，但偷着抽烟喝酒③减少数量和次数④不管他12、由于老公投资股票失误，你和老公的经济状况很差了，你会：①鼓励并帮助老公积累资本，以图东山再起②勤俭持家，和老公共患难③嘲笑老公没本事，并和他吵架④继续锦衣玉食，只管自己享受⑤离开老公，找个有钱人再嫁13、邻居的孩子把自己的孩子打了，你会：①安慰自己的孩子，问清原因，提醒他以后注意②痛斥自己的孩子，不该和邻居的孩子玩③自己到邻居家说理，要求对方道歉④纠集老公、亲属，去邻居家打架⑤教育自己的孩子，以后长大了打他14、假如你和老公买彩票中了大奖，你会：①换车、换房②买贵重首饰等奢侈品③投资④存起来以备后用⑤接济亲戚朋友⑥捐给公益事业	告诉	吵架|发现老公的手机上有一条女性发来的暧昧短信，你会：①让老公说出这个人是谁，并解释为什么会发这样的短信②装作不知道，但在心里记着③不管他，爱谁谁④逼着老公马上打电话，弄清事实⑤认定老公有外遇，与他大闹10、你自己的嗜好是：①看电视②打毛线③吃瓜子④看书⑤逛街购物⑥抽烟喝酒⑦许多种11、假如老公反对|发来的暧昧短信，你会：①让老公说出这个人是谁，并解释为什么会发这样的短信②装作不知道，但在心里记着③不管他，爱谁谁④逼着老公马上打电话，弄清事实⑤认定老公有外遇，与他大闹10、你自己的嗜好是：①看电视②打毛线③吃瓜子④看书⑤逛街购物⑥抽烟喝酒⑦许多种11、假如老公反对|反对	1
承运司机运输货物入境后，先将货物运至龙港公司，由被告人陈某东、张某秀、黄某流等人签收，再将货物运至东莞公司。	运至	签收|运至	1
据伤者表示，公交公司工作人员承诺，大伙先各自垫付医药费，随后再商讨赔偿。	垫付	商讨	1
而杜某先是提出孩子有可能不是自己的，当鉴定结果证实孩子确实是他的之后，又称自己名下没有任何财产，还拿出了中大法医物证鉴定意见书，证实自己有短暂性脑缺血、高血压病、冠心病和胆囊多发结石等多种疾病，无法抚养孩子。	提出	证实	1
临走前，工作人员还一再承诺，前两天先让孩子熟悉一下环境，不会进行体力训练，更不会体罚，等他适应了以后再开始训练。	熟悉	进行|体罚，等他适应|适应|训练	1
虽然杨老汉再三声明，但为了防止发生意外，法警还是先将他的菜刀没收了。	声明	没收	1
再次接通电话后，魏民轩第一句话就这样说道，“事情没发生之前，不知道交通肇事的可怕，等到事情发生了，我和我的家庭就整个被改变了。”	接通	发生|改变	1
经多次密谋，他们决定先由叶某将陈为诚勾引至长寿红楼旅馆，再以强奸女朋友为名实施敲诈。	勾引	实施	1
王某所谓的“钓鱼”，是先将一些真卡低价抛售给“黄牛”，以此取得他们的信任，随后再大量抛售假的购物卡。	抛售	抛售	1
姚某此前购得这批购物卡后，先将密码保护膜刮掉并一一记下每张卡的密码，然后到外地重新贴上一层“密码保护膜”，再将这些购物卡打折出售。	刮掉|记下	贴上	1
昨日清晨7点，一头长约1.1米、重约35公斤的野猪，突然蹿入巴南区黄溪街物业公司停车场内，先将一名准备开车的男子撞伤，再狂奔1公里闯入大江厂家属区内，将一位七旬老人咬伤。	撞伤	闯入	1
女学生被老师强奸案三次审理三种判决因涉嫌强奸本班女生，仪陇县法院近日以强奸罪判处这名教师四年有期徒刑■第一次判决，认定被告陶伟强犯强制猥亵妇女罪，判处有期徒刑两年■第二次判决，犯罪事实和罪名都没有改变的情况下，判一年零六个月■第三次判决，利用教育管理之便与女生强行发生性关系，强奸罪成立南充仪陇县一名初二女生被班主任老师“那个”了，检察机关两次都以强奸罪起诉，法院两次都以强制猥亵妇女罪判处，刑期从两年改为一年零六个月。	判处	认定被告陶伟强犯强制猥亵妇女罪，判处|判处	1
“侵犯了公民的权利”临猗县做出回应的第二天，随着《山西临猗惊爆“磕头门”事件》的帖子先后被转载到天涯、百度贴吧等论坛，此事被网民冠以“磕头门”、“下跪门”的称呼流传于网络，并引起网民热议。	侵犯|做出	惊爆|转载	1
只能先治疗一段时间，再想办法移植接指。	治疗	移植	1
办假证的让其先起草好一份市纪委的公文，连同首付的1000元现金放在指定的位置，由他们派人去取，并商定负责把造好的公文送至刘学明所在的村委办公室，然后再收另1000元现金。	起草	放在指定的位置，由他们派人去取，并商定负责把造好的公文送至刘学明所在的村委办公室，再收另|去取，并商定负责把造好的公文送至刘学明所在的村委办公室，再收另	1
自动挡车型自动挡车型在坡上停车时，一定要先挂入N挡位并拉紧手刹，抬起脚刹让手刹充分起作用以后再挂入P挡位。	挂入|拉紧	起作用以后挂入|挂入	1
答：我是先给他们播放几秒钟美女裸聊的视频，然后突然中断，他们急着要往下看，我说如果想再看，就要给我汇款。	播放	中断	1
处理：跋扈副局长最终被撤职临猗县做出回应的第二天，随着《山西临猗惊爆“磕头门”事件》的帖子先后被转载到天涯、百度贴吧等论坛，此事被网民冠以“磕头门”、“下跪门”的称呼流传于网络，并引起网民热议。	撤职|做出	惊爆|转载	1
她如数家珍，自2006年长沙一家电视台报道了之后，先后有包括中央媒体在内的数十家国内媒体采访过。	报道	采访	1
对于这样“偏执”的学生族，他们只能先是采取沟通、劝告，如果一再坚持，只能拒绝为其手术。	采取	坚持	1
来自武汉工程大学的李丹同学就表示，会先理智观望，会和企业沟通今后的职业规划部分，权衡一下自己在这个企业今后会不会有一个长足的发展，之后再做决定。	观望	沟通|权衡	1
目前的进度是，第一批建了13个电厂，第二批要建的25个电厂中15个已开工。	批建	开工	1
销售药品需要注意的细节很多，首先应检查厂家的药品生产批准文号、药品类型等信息；其次，还应严防“套批文”的现象，即厂家持有合法批文，但其可能生产某些自身不具备资质生产的药品，然后以合法的批文作为伪装，捏造一个其他类型药品的批文号，而这样做的目的很明确：多卖产品、多赚钱。	检查	持有|生产	1
今年4月，阿飞再次向禅城法院提出离婚诉讼，5月底进行了第一次开庭。	提出	进行	1
一位李姓书记称，鸣枪打人者可能是刑侦大队的干警，但绝不是大队长杨忠平，并要求家长们先回去，一周之后告知其调查结果。	要求	告知	1
但是，判决书生效之后，胡女士的3个子女都先后搬出去租房居住，其小儿子虽然搬走了，但结婚时买的几个大柜子始终没有搬走，且小儿子还用锁把当初其居住的卧室锁起来，致使胡女士无法自由出入。	生效	搬走|出入	1
为核实钱是否到帐，吴先生当晚特地到当地步行街上一家建行的ATM机上查询余额，之后这张卡就再没使用过。	查询	使用	1
因为两次饮酒驾车，8月23日，聂师傅先到交警二分局接受了处罚，然后又到交警五分局接受处罚。	接受	接受	1
耒阳赴深工作组相关负责人昨晚向记者证实，补偿款分为两笔，第一笔400多万元已经拨到耒阳，第二笔款项将在两三天内到账。	拨到	到账	1
从2006年5月至2007年3月，谢友良利用老师身份，骗取学生及家长、老师的信任，先后介绍女学生杨某(1992年12月出生)、刘某、陈某某(1993年6月出生)，到丁坤处参加体育训练，再由丁坤将她们介绍给他人。	介绍	参加|介绍	1
她提醒，第一天家长可以全天陪同，适当过渡一两天之后，不管孩子如何哭闹都不要心软，也不管孩子找什么样的理由逃避上学，都要坚持送去，并用“你长大了”“你可以上学了”的言语来鼓励。	陪同	过渡	1
在招考“淘粪工”的过程中，不少人质疑：这些考生是否会先获得一个事业编制，再选择跳槽？	获得	选择跳槽	1
之后李女士拿出和丈夫的12万积蓄，又从她父母那借了6万元交了首付，以王先生的名义购买了新房。	拿出	购买	1
事后，王先生承认了自己的错误，并一再发誓不会再发生这样的事，可李女士的心却死了。	承认	发生	1
冒充“银监局”电话转接到“银监局”后，工作人员立即让张先生把钱转到银监局提供的“安全账户”，待弄清情况后再还给他。	转到银监局提供	还给	1
前天下午，办案民警再次赶往郎溪县，经蹲点守候，一举在郎溪县建平镇第一步行街将李某抓获归案。	赶往	抓获	1
“第一次跟着我们出去，有主人在旁边，狗狗也比较听话比较乖，不会因为跟着陌生人出去而变得很敏感，这样有利于我们和狗狗建立起感情，接下来我们单独带狗狗出去遛时将会更顺利。”	跟着我们出去	变得很敏感，这样有利于我们和狗狗建立|建立	1
周科长介绍，熏蒸杀虫剂“56%磷化铝片剂”，是一种常见杀虫剂，多用于熏杀粮食、种子仓库内的害虫，但其使用方法有严格标准：熏蒸粮食、种子时，每75~150公斤用药一片，药片要用纱布包裹好，放入粮内20~30厘米处，密封容器7天以上；杀虫完毕后，须先打开容器，取出药渣倒掉，放气5天以上，才能再行运输、交易粮食。	打开	交易	1
代先生掏出手机，刘欢《从头再来》悠扬的曲调回荡在病房内。	掏出	回荡	1
刘英说，当时她的想法很简单，先互相认识一下，再慢慢相处。	认识	相处	1
据审理查明：2007年1月至2008年7月间，邓建忠通过QQ聊天先后认识多名女性，然后其假冒刑事警察身份，骗取黄花(化名)等9名女性的信任，与部分受害人发生性关系并诈骗财物合计6.2万余元。	认识	假冒	1
突然，6名手持枪支和尖刀的歹徒冲进四楼的一个包间内，分别将6名客人控制，先用透明胶将各人嘴眼封住，用绳子捆住手脚，然后进行搜身，将客人身上的现金、手机、手表、银行卡、金项链等洗劫一空。	封住	捆住	1
按东至县公安局《提请批准逮捕书》，该案第二被告人许再进、第三被告人徐文胜从2008年6月26日被关押至今已快一年三个月，第一被告人查道友从2008年8月6日被关押至今也已将近一年一个月，早就构成了超期羁押。	关押	关押|构成	1
为了防止男子情绪过激出现意外，民警先将围观者疏散开，再小心地靠近，并和男子说话。	疏散	靠近	1
店长获悉情况后也表示不同意，她先打了110，在得知民警确实有行动之后，仍然不理解，又电话通知了便利店所在大厦的保安。	打了	得知	1
根据两人血腥的屠杀计划，2009年4月20日这天，他们将先在曼彻斯特市“北方王冠点”商业中心内引爆一枚炸弹，然后再携带枪支炸弹冲入母校血洗校园，两人希望在这两起袭击事件中共杀死“数千人”，从而制造出“有史以来最轰动的校园大屠杀血案”。	引爆	携带|冲入|血洗	1
至于到底哪种程度上的差别算大，金宇航说，等结果出来后，先与家人开个会，然后再与其他两家人商量。	开个	商量	1
昨日上午陶女士通过电话与该厂负责人匡（音）先生取得了联系，他答应次日会再派人协商。	取得	协商	1
刘先生开始三番五次拨打客服热线投诉，甚至已经记住了好几个客服代表的号码，但每次对方的回复都是一样，只能做登记，然后上交处理，而再无其他解决问题的办法。	拨打	记住	1
该家庭2008年10月28日经过海珠区龙凤街道办事处的初审，10月28日至11月10日通过了第一次公示，2009年1月14日通过了市房管局海珠区分局的复审，1月19日至2月5日通过了第二次公示。	通过	通过|通过	1
如果确实有人投错了钱，公司首先要调查清楚，然后再按程序进行处理。	调查	处理	1
这名负责人说：“事件调查清楚之后，公司会有人员与翟先生进行联系，请他耐心等待。”	调查	等待	1
陈义侃说，根据“阿华”的安排，三人先从福建飞往上海，之后在上海的一家旅馆他见到了这三名少年。	飞往	见到	1
警方分析，犯罪嫌疑人很可能骑摩托车先逃往临安方向，再从临安进入杭州。	逃往	进入	1
不少网友都说，以后买东西，一定要让商家“先关机，再开启，最后再称量”。	关机	开启	1
黄长久夫妇第一胎是在1985年生育的，1988年再生育一女肯定不符合政策，作为村干部的黄长久于是将女儿抱养了出去。	生育	生育	1
考虑到事情的严重性和学校刚开学，当晚学校先召开了班主任会议通报这起事件，第二天就向全校老师通报。	召开|通报	通报	1
仅25.8%的的哥体检合格的哥马师傅在打档时猝死之后，南京交通台首先对这一事件进行了报道，记者在昨天的采访中，也采访了一些出租车司机。	猝死	报道|采访	1
考生们据此怀疑，发帖者先是发了一个没有实际内容的标题帖，待考试结束后，找人专门负责回忆答案，再修改帖子补充内容，以此造成考题提前泄露的假象，“况且既然泄题，为什么有那么多错误答案，为什么有的题还没有答案呢？”	发了	修改	1
3月28日，他第一次发短信给潘某荣敲诈10万元，之后又时不时地发短信骚扰潘家。	敲诈	骚扰	1
发短信的人表示，希望老邹先“赞助10万元消遣消遣”，否则就将老邹的女儿绑架，再强行索要100万元。	赞助	绑架|索要	1
发短信的人表示，希望老邹先“赞助10万元消遣消遣”，否则就将老邹的女儿绑架，再强行索要100万元。	赞助	绑架|索要	1
两人人商定先去了解李某某的活动规律后，再最终决定作案时间。	商定|了解	决定	1
事后，按照事先预谋，郝某某将车开上了201国道，来到了事先挖好的大坑旁，郝某父子一起将李某某的尸体放入坑中，把铁丝网盖在了尸体上面，然后又把水泥灌在了铁丝网上面，最后然后用土掩埋……	来到	放入	1
可授权银行及时冻结嫌疑账户某银行职员张先生：可授权银行及时冻结嫌疑账户在银行工作的张先生则从打击犯罪的角度建议有关部门授权各家银行对诸如“这里是××公安局，我们正在侦查×××案件，请你立即转账到××账户，以避免损失”等各种诈骗信息内所列的账号及时进行冻结，然后追查开户人，这样可以从根本上解决诈骗短信漫天飞的问题。	授权|冻结|授权	侦查|转账|追查	1
杨主任介绍，公布邮箱的程序是，先由他们将邮箱提供给区政府办公室，然后再由区政府办公室提供各媒体，应该是在公布环节出了问题，才造成邮箱错误。	提供	提供	1
弗朗西斯第一次接受行刑是在路易斯安那，结果电刑失败而获得将近一年死缓，等待美国最高法院就执行第二次电刑是否违宪做出决定。	接受	获得	1
由于派出所不接受单位和个人捐赠，他先将车送给了学校保卫处，再由保卫处提供给派出所使用。	送给	提供	1
由于派出所不接受单位和个人捐赠，他先将车送给了学校保卫处，再由保卫处提供给派出所使用。	送给	提供	1
1年多后，刘多莉的第二个孩子又要出生了，王淑成预先给孩子取好名字“彭伟”，意为“勇敢地打仗，最后取得伟大胜利”。	出生	取|取得	1
出于人性化执法，民警便让这名男子先去办理手续，待手续完结后再带往派出所接受调查处理。	办理	带往派出所接受|接受	1
